2019,Player,Pos,Age,Tm,G,GS,MP,FG,FGA,FG%,3P,3PA,3P%,2P,2PA,2P%,eFG%,FT,FTA,FT%,ORB,DRB,TRB,AST,STL,BLK,TOV,PF,PTS
2019,Steven Adams\adamsst01,C,26,OKC,58,58,1564,262,443,0.591,1,3,0.333,261,440,0.593,0.593,108,183,0.59,196,347,543,141,50,65,86,111,633
2019,Bam Adebayo\adebaba01,PF,22,MIA,65,65,2235,408,719,0.567,1,13,0.077,407,706,0.576,0.568,236,342,0.69,165,518,683,333,78,85,185,164,1053
2019,LaMarcus Aldridge\aldrila01,C,34,SAS,53,53,1754,391,793,0.493,61,157,0.389,330,636,0.519,0.532,158,191,0.827,103,289,392,129,36,87,74,128,1001
2019,Nickeil Alexander-Walker\alexani01,SG,21,NOP,41,0,501,77,227,0.339,40,117,0.342,37,110,0.336,0.427,17,28,0.607,8,72,80,74,11,7,40,46,211
2019,Grayson Allen\allengr01,SG,24,MEM,30,0,498,79,176,0.449,33,91,0.363,46,85,0.541,0.543,30,35,0.857,5,61,66,43,6,1,23,36,221
2019,Jarrett Allen\allenja01,C,21,BRK,64,58,1647,267,413,0.646,0,5,0,267,408,0.654,0.646,147,237,0.62,195,410,605,85,37,85,72,144,681
2019,Kadeem Allen\allenka01,SG,27,NYK,10,0,117,19,44,0.432,5,16,0.313,14,28,0.5,0.489,7,11,0.636,2,7,9,21,5,2,8,7,50
2019,Al-Farouq Aminu\aminual01,PF,29,ORL,18,2,380,25,86,0.291,9,36,0.25,16,50,0.32,0.343,19,29,0.655,24,63,87,21,18,8,17,27,78
2019,Justin Anderson\anderju01,SF,26,BRK,3,0,17,1,6,0.167,0,3,0,1,3,0.333,0.167,1,2,0.5,0,2,2,0,0,1,0,2,3
2019,Kyle Anderson\anderky01,PF,26,MEM,59,20,1140,138,280,0.493,16,62,0.258,122,218,0.56,0.521,43,66,0.652,54,203,257,132,46,31,55,85,335
2019,Ryan Anderson\anderry01,PF,31,HOU,2,0,14,2,7,0.286,1,5,0.2,1,2,0.5,0.357,0,0,,0,7,7,2,1,0,1,1,5
2019,Giannis Antetokounmpo\antetgi01,PF,25,MIL,57,57,1763,623,1139,0.547,83,271,0.306,540,868,0.622,0.583,361,570,0.633,130,653,783,329,59,58,209,173,1690
2019,Kostas Antetokounmpo\antetko01,PF,22,LAL,3,0,5,0,0,,0,0,,0,0,,,0,0,,0,1,1,1,0,0,0,0,0
2019,Thanasis Antetokounmpo\antetth01,SF,27,MIL,18,2,93,19,36,0.528,0,7,0,19,29,0.655,0.528,7,15,0.467,11,8,19,9,6,2,11,13,45
2019,Carmelo Anthony\anthoca01,PF,35,POR,50,50,1623,289,679,0.426,72,194,0.371,217,485,0.447,0.479,113,134,0.843,61,252,313,79,40,23,87,142,763
2019,OG Anunoby\anunoog01,SF,22,TOR,63,62,1897,267,527,0.507,82,215,0.381,185,312,0.593,0.584,59,86,0.686,74,267,341,99,88,42,75,155,675
2019,Ryan Arcidiacono\arcidry01,PG,25,CHI,58,4,930,90,220,0.409,54,138,0.391,36,82,0.439,0.532,27,38,0.711,20,90,110,96,27,3,37,96,261
2019,Trevor Ariza\arizatr01,SF,34,TOT,53,21,1493,142,324,0.438,77,207,0.372,65,117,0.556,0.557,62,74,0.838,34,212,246,91,69,15,56,111,423
2019,Trevor Ariza\arizatr01,SF,34,SAC,32,0,791,64,165,0.388,43,122,0.352,21,43,0.488,0.518,21,27,0.778,21,125,146,50,35,7,28,63,192
2019,Trevor Ariza\arizatr01,SF,34,POR,21,21,702,78,159,0.491,34,85,0.4,44,74,0.595,0.597,41,47,0.872,13,87,100,41,34,8,28,48,231
2019,D.J. Augustin\augusdj01,PG,32,ORL,49,6,1215,156,397,0.393,60,174,0.345,96,223,0.43,0.469,139,157,0.885,18,91,109,223,30,1,69,53,511
2019,Deandre Ayton\aytonde01,C,21,PHO,30,25,996,255,465,0.548,0,3,0,255,462,0.552,0.548,60,78,0.769,123,237,360,57,22,51,71,97,570
2019,Dwayne Bacon\bacondw01,SG,24,CHO,39,11,687,85,244,0.348,19,67,0.284,66,177,0.373,0.387,35,53,0.66,15,85,100,52,23,2,37,52,224
2019,Marvin Bagley III\baglema01,PF,20,SAC,13,6,334,78,167,0.467,4,22,0.182,74,145,0.51,0.479,25,31,0.806,29,68,97,10,6,12,18,43,185
2019,Lonzo Ball\balllo01,PG,22,NOP,56,47,1817,259,628,0.412,139,363,0.383,120,265,0.453,0.523,38,67,0.567,63,285,348,392,80,30,172,110,695
2019,Mo Bamba\bambamo01,C,21,ORL,60,0,868,132,282,0.468,37,104,0.356,95,178,0.534,0.534,31,46,0.674,98,201,299,42,22,85,42,115,332
2019,J.J. Barea\bareajo01,PG,35,DAL,26,4,391,74,179,0.413,29,76,0.382,45,103,0.437,0.494,17,18,0.944,10,38,48,99,4,2,35,25,194
2019,Harrison Barnes\barneha02,PF,27,SAC,64,64,2231,326,711,0.459,93,243,0.383,233,468,0.498,0.524,196,244,0.803,61,245,306,152,38,10,80,82,941
2019,RJ Barrett\barrerj01,SG,19,NYK,56,55,1704,292,727,0.402,63,197,0.32,229,530,0.432,0.445,156,254,0.614,50,229,279,143,55,17,124,122,803
2019,Will Barton\bartowi01,SF,29,DEN,58,58,1916,332,738,0.45,108,288,0.375,224,450,0.498,0.523,102,133,0.767,76,289,365,212,61,29,88,121,874
2019,Keita Bates-Diop\bateske01,SF,24,TOT,39,0,665,89,208,0.428,31,94,0.33,58,114,0.509,0.502,49,69,0.71,21,91,112,30,17,21,14,38,258
2019,Keita Bates-Diop\bateske01,SF,24,MIN,37,0,646,87,206,0.422,31,94,0.33,56,112,0.5,0.498,46,65,0.708,21,89,110,30,17,20,14,36,251
2019,Keita Bates-Diop\bateske01,SF,24,DEN,2,0,19,2,2,1,0,0,,2,2,1,1,3,4,0.75,0,2,2,0,0,1,0,2,7
2019,Nicolas Batum\batumni01,SF,31,CHO,22,3,505,28,81,0.346,14,49,0.286,14,32,0.438,0.432,9,10,0.9,25,75,100,66,17,8,22,41,79
2019,Aron Baynes\baynear01,C,33,PHO,42,28,934,183,381,0.48,59,168,0.351,124,213,0.582,0.558,56,75,0.747,71,166,237,67,10,23,50,141,481
2019,Kent Bazemore\bazemke01,SF-SG,30,TOT,64,21,1604,185,495,0.374,78,228,0.342,107,267,0.401,0.453,109,142,0.768,24,253,277,85,70,39,85,182,557
2019,Kent Bazemore\bazemke01,SF,30,POR,43,21,1111,113,326,0.347,56,171,0.327,57,155,0.368,0.433,58,72,0.806,13,159,172,61,45,31,60,121,340
2019,Kent Bazemore\bazemke01,SG,30,SAC,21,0,493,72,169,0.426,22,57,0.386,50,112,0.446,0.491,51,70,0.729,11,94,105,24,25,8,25,61,217
2019,Darius Bazley\bazleda01,PF,19,OKC,53,8,909,88,230,0.383,30,100,0.3,58,130,0.446,0.448,32,47,0.681,21,175,196,29,20,35,40,45,238
2019,Bradley Beal\bealbr01,SG,26,WAS,57,57,2053,593,1303,0.455,170,481,0.353,423,822,0.515,0.52,385,457,0.842,52,190,242,347,71,23,194,126,1741
2019,Malik Beasley\beaslma01,SG,23,TOT,55,14,1209,227,534,0.425,107,276,0.388,120,258,0.465,0.525,54,66,0.818,18,130,148,75,40,8,57,77,615
2019,Malik Beasley\beaslma01,SG,23,DEN,41,0,746,117,301,0.389,58,161,0.36,59,140,0.421,0.485,33,38,0.868,9,68,77,48,31,6,36,50,325
2019,Malik Beasley\beaslma01,SG,23,MIN,14,14,463,110,233,0.472,49,115,0.426,61,118,0.517,0.577,21,28,0.75,9,62,71,27,9,2,21,27,290
2019,Marco Belinelli\belinma01,SG,33,SAS,52,0,779,106,271,0.391,57,155,0.368,49,116,0.422,0.496,32,41,0.78,4,86,90,64,10,1,16,41,301
2019,Jordan Bell\belljo01,C-PF,25,TOT,29,0,256,35,67,0.522,4,12,0.333,31,55,0.564,0.552,19,31,0.613,30,51,81,16,3,10,21,19,93
2019,Jordan Bell\belljo01,C,25,MIN,27,0,235,32,60,0.533,2,9,0.222,30,51,0.588,0.55,17,29,0.586,28,50,78,14,2,10,18,17,83
2019,Jordan Bell\belljo01,PF,25,MEM,2,0,21,3,7,0.429,2,3,0.667,1,4,0.25,0.571,2,2,1,2,1,3,2,1,0,3,2,10
2019,DeAndre' Bembry\bembrde01,SG,25,ATL,43,4,915,104,228,0.456,15,65,0.231,89,163,0.546,0.489,26,48,0.542,34,118,152,81,55,19,60,84,249
2019,Dragan Bender\bendedr01,SF,22,TOT,16,3,286,41,92,0.446,15,43,0.349,26,49,0.531,0.527,10,14,0.714,16,57,73,28,4,9,21,42,107
2019,Dragan Bender\bendedr01,SF,22,MIL,7,0,91,10,21,0.476,4,9,0.444,6,12,0.5,0.571,2,3,0.667,0,20,20,9,0,5,5,16,26
2019,Dragan Bender\bendedr01,SF,22,GSW,9,3,195,31,71,0.437,11,34,0.324,20,37,0.541,0.514,8,11,0.727,16,37,53,19,4,4,16,26,81
2019,Dāvis Bertāns\bertada01,PF,27,WAS,54,4,1583,265,610,0.434,200,472,0.424,65,138,0.471,0.598,104,122,0.852,35,210,245,92,37,33,59,139,834
2019,Patrick Beverley\beverpa01,PG,31,LAC,48,48,1299,139,325,0.428,75,198,0.379,64,127,0.504,0.543,27,41,0.659,56,203,259,179,53,25,64,150,380
2019,Khem Birch\birchkh01,C,27,ORL,40,24,777,56,115,0.487,0,1,0,56,114,0.491,0.487,41,67,0.612,70,110,180,35,16,21,23,73,153
2019,Goga Bitadze\bitadgo01,C,20,IND,49,2,410,61,129,0.473,6,36,0.167,55,93,0.591,0.496,24,33,0.727,22,74,96,21,6,32,25,57,152
2019,Bismack Biyombo\biyombi01,C,27,CHO,53,29,1029,151,278,0.543,0,0,,151,278,0.543,0.543,91,151,0.603,120,188,308,50,10,49,48,116,393
2019,Nemanja Bjelica\bjeline01,PF,31,SAC,64,61,1821,287,604,0.475,125,295,0.424,162,309,0.524,0.579,60,73,0.822,107,305,412,179,54,33,92,193,759
2019,Eric Bledsoe\bledser01,PG,30,MIL,56,56,1524,319,662,0.482,70,201,0.348,249,461,0.54,0.535,157,193,0.813,41,218,259,302,53,25,140,120,865
2019,Bogdan Bogdanović\bogdabo01,SG,27,SAC,53,20,1510,277,639,0.433,137,380,0.361,140,259,0.541,0.541,76,105,0.724,17,154,171,169,54,14,89,115,767
2019,Bojan Bogdanović\bogdabo02,SF,30,UTA,63,63,2083,418,935,0.447,189,457,0.414,229,478,0.479,0.548,250,277,0.903,39,220,259,131,34,7,159,110,1275
2019,Jonah Bolden\boldejo01,PF,24,TOT,7,0,47,4,11,0.364,0,4,0,4,7,0.571,0.364,2,4,0.5,3,6,9,0,3,2,2,10,10
2019,Jonah Bolden\boldejo01,PF,24,PHI,4,0,14,2,3,0.667,0,1,0,2,2,1,0.667,0,2,0,0,1,1,0,1,0,2,4,4
2019,Jonah Bolden\boldejo01,PF,24,PHO,3,0,33,2,8,0.25,0,3,0,2,5,0.4,0.25,2,2,1,3,5,8,0,2,2,0,6,6
2019,Marques Bolden\boldema01,C,21,CLE,1,0,3,0,0,,0,0,,0,0,,,0,0,,0,2,2,0,1,0,0,1,0
2019,Jordan Bone\bonejo01,PG,22,DET,10,0,53,5,20,0.25,2,10,0.2,3,10,0.3,0.3,0,0,,0,4,4,8,1,0,2,6,12
2019,Isaac Bonga\bongais01,SF,20,WAS,58,41,1025,96,184,0.522,22,55,0.4,74,129,0.574,0.582,52,64,0.813,61,122,183,61,37,21,41,136,266
2019,Devin Booker\bookede01,SG,23,PHO,62,62,2241,544,1118,0.487,126,350,0.36,418,768,0.544,0.543,405,442,0.916,27,231,258,408,45,16,244,188,1619
2019,Chris Boucher\bouchch01,PF,27,TOR,55,0,724,119,260,0.458,28,99,0.283,91,161,0.565,0.512,82,103,0.796,94,148,242,23,20,53,23,104,348
2019,Brian Bowen\bowenbr02,SG,21,IND,5,1,29,2,9,0.222,0,2,0,2,7,0.286,0.222,0,0,,1,6,7,0,0,1,1,2,4
2019,Ky Bowman\bowmaky01,PG,22,GSW,45,12,1015,134,321,0.417,33,107,0.308,101,214,0.472,0.469,34,41,0.829,24,97,121,131,44,10,70,102,335
2019,Avery Bradley\bradlav01,SG,29,LAL,49,44,1186,170,383,0.444,63,173,0.364,107,210,0.51,0.526,20,24,0.833,18,97,115,63,43,5,47,110,423
2019,Tony Bradley\bradlto01,C,22,UTA,50,2,535,103,155,0.665,1,1,1,102,154,0.662,0.668,26,40,0.65,90,126,216,17,12,25,23,98,233
2019,Jarrell Brantley\brantja01,PF,23,UTA,5,0,13,0,0,,0,0,,0,0,,,0,0,,0,5,5,1,0,2,2,2,0
2019,Ignas Brazdeikis\brazdig01,SF,21,NYK,9,0,53,6,22,0.273,1,9,0.111,5,13,0.385,0.295,4,5,0.8,2,3,5,4,0,1,2,3,17
2019,Mikal Bridges\bridgmi01,SF,23,PHO,65,24,1772,210,407,0.516,56,159,0.352,154,248,0.621,0.585,89,105,0.848,59,200,259,115,93,39,65,142,565
2019,Miles Bridges\bridgmi02,SF,21,CHO,65,64,1995,319,753,0.424,99,300,0.33,220,453,0.486,0.489,106,131,0.809,88,274,362,114,40,48,95,132,843
2019,Oshae Brissett\brissos01,SF,21,TOR,19,0,135,13,36,0.361,3,15,0.2,10,21,0.476,0.403,8,10,0.8,9,17,26,7,4,1,7,18,37
2019,Ryan Broekhoff\broekry01,SG,29,DAL,17,1,180,22,59,0.373,20,51,0.392,2,8,0.25,0.542,7,8,0.875,5,38,43,11,5,4,6,15,71
2019,Malcolm Brogdon\brogdma01,PG,27,IND,48,48,1472,289,659,0.439,61,195,0.313,228,464,0.491,0.485,145,162,0.895,40,186,226,343,33,8,115,88,784
2019,Dillon Brooks\brookdi01,SG,24,MEM,65,65,1851,372,925,0.402,132,358,0.369,240,567,0.423,0.474,144,178,0.809,61,152,213,128,57,25,108,246,1020
2019,Bruce Brown\brownbr01,SG,23,DET,58,43,1634,198,447,0.443,33,96,0.344,165,351,0.47,0.48,88,119,0.739,61,213,274,230,63,29,100,162,517
2019,Charlie Brown\brownch02,SG,22,ATL,10,0,40,6,19,0.316,3,9,0.333,3,10,0.3,0.395,5,5,1,2,2,4,2,2,2,3,3,20
2019,Jaylen Brown\brownja02,SF,23,BOS,50,50,1702,378,772,0.49,107,281,0.381,271,491,0.552,0.559,159,216,0.736,54,264,318,109,56,16,116,151,1022
2019,Moses Brown\brownmo01,C,20,POR,9,0,33,4,10,0.4,0,0,,4,10,0.4,0.4,3,8,0.375,3,11,14,1,1,1,3,7,11
2019,Sterling Brown\brownst02,SF,24,MIL,45,1,665,80,218,0.367,36,114,0.316,44,104,0.423,0.45,27,35,0.771,28,137,165,46,22,7,36,45,223
2019,Troy Brown Jr.\browntr01,SG,20,WAS,61,14,1519,229,506,0.453,50,145,0.345,179,361,0.496,0.502,86,114,0.754,64,261,325,142,76,6,65,110,594
2019,Jalen Brunson\brunsja01,PG,23,DAL,57,16,1022,181,388,0.466,43,120,0.358,138,268,0.515,0.522,61,75,0.813,22,112,134,188,22,4,66,74,466
2019,Thomas Bryant\bryanth01,C,22,WAS,38,28,901,184,307,0.599,22,54,0.407,162,253,0.64,0.635,70,95,0.737,75,185,260,71,14,33,48,85,460
2019,Reggie Bullock\bullore01,SG,28,NYK,29,19,684,90,224,0.402,37,111,0.333,53,113,0.469,0.484,17,21,0.81,13,55,68,42,25,3,19,56,234
2019,Trey Burke\burketr01,PG,27,PHI,25,0,329,59,127,0.465,16,38,0.421,43,89,0.483,0.528,13,18,0.722,15,20,35,53,7,1,12,21,147
2019,Alec Burks\burksal01,SG,28,TOT,59,18,1612,283,701,0.404,100,273,0.366,183,428,0.428,0.475,225,251,0.896,43,219,262,171,58,17,85,120,891
2019,Alec Burks\burksal01,SG,28,GSW,48,18,1390,244,601,0.406,84,224,0.375,160,377,0.424,0.476,201,224,0.897,37,189,226,151,50,17,76,107,773
2019,Alec Burks\burksal01,SG,28,PHI,11,0,222,39,100,0.39,16,49,0.327,23,51,0.451,0.47,24,27,0.889,6,30,36,20,8,0,9,13,118
2019,Deonte Burton\burtode02,SG,26,OKC,34,0,284,39,105,0.371,10,46,0.217,29,59,0.492,0.419,6,12,0.5,6,42,48,11,5,10,14,28,94
2019,Jimmy Butler\butleji01,SF,30,MIA,54,54,1851,328,722,0.454,29,117,0.248,299,605,0.494,0.474,408,490,0.833,98,261,359,331,92,29,118,74,1093
2019,Bruno Caboclo\cabocbr01,SF,24,TOT,27,0,220,32,77,0.416,4,28,0.143,28,49,0.571,0.442,4,5,0.8,22,31,53,12,12,16,9,25,72
2019,Bruno Caboclo\cabocbr01,SF,24,MEM,22,0,192,28,69,0.406,4,25,0.16,24,44,0.545,0.435,2,3,0.667,17,27,44,10,10,12,7,23,62
2019,Bruno Caboclo\cabocbr01,SF,24,HOU,5,0,28,4,8,0.5,0,3,0,4,5,0.8,0.5,2,2,1,5,4,9,2,2,4,2,2,10
2019,Kentavious Caldwell-Pope\caldwke01,SG,26,LAL,63,20,1603,220,466,0.472,87,221,0.394,133,245,0.543,0.565,74,95,0.779,37,95,132,105,53,13,55,117,601
2019,Vlatko Čančar\cancavl01,SF,22,DEN,14,0,45,6,15,0.4,1,6,0.167,5,9,0.556,0.433,4,4,1,5,5,10,3,1,1,3,7,17
2019,Clint Capela\capelca01,C,25,HOU,39,39,1279,244,388,0.629,0,0,,244,388,0.629,0.629,55,104,0.529,168,369,537,48,33,72,63,102,543
2019,DeMarre Carroll\carrode01,SF,33,TOT,21,0,231,21,54,0.389,7,27,0.259,14,27,0.519,0.454,24,36,0.667,11,36,47,18,4,4,16,28,73
2019,DeMarre Carroll\carrode01,SF,33,SAS,15,0,135,9,29,0.31,3,13,0.231,6,16,0.375,0.362,12,20,0.6,7,24,31,11,2,2,10,20,33
2019,DeMarre Carroll\carrode01,SF,33,HOU,6,0,96,12,25,0.48,4,14,0.286,8,11,0.727,0.56,12,16,0.75,4,12,16,7,2,2,6,8,40
2019,Jevon Carter\carteje01,PG,24,PHO,50,2,754,82,205,0.4,46,117,0.393,36,88,0.409,0.512,21,25,0.84,25,73,98,65,38,13,31,76,231
2019,Vince Carter\cartevi01,SF,43,ATL,60,0,876,107,304,0.352,61,202,0.302,46,102,0.451,0.452,23,29,0.793,18,106,124,48,23,25,33,90,298
2019,Wendell Carter Jr.\cartewe01,C,20,CHI,43,43,1256,183,343,0.534,6,29,0.207,177,314,0.564,0.542,112,152,0.737,139,266,405,51,33,36,72,162,484
2019,Michael Carter-Williams\cartemi01,SG,28,ORL,42,0,773,105,242,0.434,20,68,0.294,85,174,0.489,0.475,72,87,0.828,44,96,140,102,45,20,48,78,302
2019,Alex Caruso\carusal01,PG,25,LAL,58,1,1032,110,260,0.423,38,107,0.355,72,153,0.471,0.496,58,76,0.763,14,98,112,102,60,17,46,85,316
2019,Willie Cauley-Stein\caulewi01,C,26,TOT,54,39,1097,175,302,0.579,0,1,0,175,301,0.581,0.579,40,66,0.606,84,231,315,70,49,61,40,121,390
2019,Willie Cauley-Stein\caulewi01,C,26,GSW,41,37,940,144,257,0.56,0,0,,144,257,0.56,0.56,35,57,0.614,71,184,255,60,45,50,35,102,323
2019,Willie Cauley-Stein\caulewi01,C,26,DAL,13,2,157,31,45,0.689,0,1,0,31,44,0.705,0.689,5,9,0.556,13,47,60,10,4,11,5,19,67
2019,Tyson Chandler\chandty01,C,37,HOU,26,5,219,14,18,0.778,0,0,,14,18,0.778,0.778,6,13,0.462,25,41,66,6,6,8,8,32,34
2019,Wilson Chandler\chandwi01,SF,32,BRK,35,3,734,74,183,0.404,37,121,0.306,37,62,0.597,0.505,20,23,0.87,11,134,145,39,16,12,34,79,205
2019,Joe Chealey\chealjo01,PG,24,CHO,4,0,33,0,7,0,0,4,0,0,3,0,0,2,2,1,0,0,0,1,4,0,2,2,2
2019,Zylan Cheatham\cheatzy01,SF,24,NOP,3,0,31,2,5,0.4,0,1,0,2,4,0.5,0.4,0,0,,1,5,6,2,0,1,3,5,4
2019,Chris Chiozza\chiozch01,PG,24,TOT,21,0,249,32,79,0.405,18,41,0.439,14,38,0.368,0.519,2,2,1,6,29,35,48,15,2,17,23,84
2019,Chris Chiozza\chiozch01,PG,24,WAS,10,0,123,10,34,0.294,7,16,0.438,3,18,0.167,0.397,0,0,,0,15,15,28,10,2,9,12,27
2019,Chris Chiozza\chiozch01,PG,24,BRK,11,0,126,22,45,0.489,11,25,0.44,11,20,0.55,0.611,2,2,1,6,14,20,20,5,0,8,11,57
2019,Marquese Chriss\chrisma01,PF,22,GSW,59,21,1196,210,385,0.545,8,39,0.205,202,346,0.584,0.556,120,156,0.769,114,251,365,114,39,62,78,122,548
2019,Gary Clark\clarkga01,PF,25,TOT,35,1,425,38,101,0.376,28,86,0.326,10,15,0.667,0.515,8,9,0.889,27,58,85,15,5,14,5,31,112
2019,Gary Clark\clarkga01,PF,25,HOU,18,0,212,23,59,0.39,18,51,0.353,5,8,0.625,0.542,6,7,0.857,11,29,40,12,2,7,2,21,70
2019,Gary Clark\clarkga01,PF,25,ORL,17,1,213,15,42,0.357,10,35,0.286,5,7,0.714,0.476,2,2,1,16,29,45,3,3,7,3,10,42
2019,Brandon Clarke\clarkbr01,PF,23,MEM,50,3,1086,254,408,0.623,21,52,0.404,233,356,0.654,0.648,73,93,0.785,78,214,292,72,26,42,46,82,602
2019,Jordan Clarkson\clarkjo01,SG,27,TOT,63,0,1527,350,753,0.465,130,353,0.368,220,400,0.55,0.551,122,145,0.841,47,120,167,124,43,15,82,92,952
2019,Jordan Clarkson\clarkjo01,SG,27,CLE,29,0,666,144,326,0.442,59,159,0.371,85,167,0.509,0.532,76,86,0.884,21,48,69,70,17,8,39,33,423
2019,Jordan Clarkson\clarkjo01,SG,27,UTA,34,0,861,206,427,0.482,71,194,0.366,135,233,0.579,0.566,46,59,0.78,26,72,98,54,26,7,43,59,529
2019,Nicolas Claxton\claxtni01,PF,20,BRK,15,0,187,27,48,0.563,1,7,0.143,26,41,0.634,0.573,11,21,0.524,19,25,44,16,1,8,9,14,66
2019,Chris Clemons\clemoch01,SG,22,HOU,29,0,251,51,126,0.405,33,94,0.351,18,32,0.563,0.536,6,7,0.857,3,20,23,22,6,5,17,20,141
2019,Antonius Cleveland\clevean01,SG,25,DAL,6,0,22,2,6,0.333,0,1,0,2,5,0.4,0.333,1,2,0.5,0,3,3,0,1,1,1,2,5
2019,Amir Coffey\coffeam01,SG,22,LAC,13,0,98,13,33,0.394,1,7,0.143,12,26,0.462,0.409,1,3,0.333,4,10,14,9,1,1,3,12,28
2019,John Collins\collijo01,PF,22,ATL,41,41,1363,353,605,0.583,59,147,0.401,294,458,0.642,0.632,120,150,0.8,116,300,416,60,31,66,75,138,885
2019,Zach Collins\colliza01,PF,22,POR,3,3,86,9,19,0.474,3,7,0.429,6,12,0.5,0.553,6,6,1,4,8,12,6,0,2,6,11,27
2019,Mike Conley\conlemi01,PG,32,UTA,41,35,1171,197,486,0.405,80,213,0.376,117,273,0.429,0.488,93,117,0.795,27,106,133,178,31,4,76,92,567
2019,Pat Connaughton\connapa01,SG,27,MIL,61,1,1119,119,261,0.456,44,137,0.321,75,124,0.605,0.54,27,36,0.75,56,203,259,95,20,30,47,60,309
2019,Quinn Cook\cookqu01,PG,26,LAL,38,0,409,76,173,0.439,25,66,0.379,51,107,0.477,0.512,6,9,0.667,7,33,40,40,11,1,25,23,183
2019,Tyler Cook\cookty01,PF,22,CLE,11,0,35,7,10,0.7,0,0,,7,10,0.7,0.7,5,6,0.833,4,6,10,1,1,0,1,4,19
2019,Robert Covington\covinro01,PF,29,TOT,62,60,1867,280,648,0.432,148,424,0.349,132,224,0.589,0.546,86,108,0.796,54,343,397,74,95,80,93,196,794
2019,Robert Covington\covinro01,PF,29,MIN,48,47,1411,216,496,0.435,108,312,0.346,108,184,0.587,0.544,75,94,0.798,36,251,287,56,80,45,73,148,615
2019,Robert Covington\covinro01,PF,29,HOU,14,13,456,64,152,0.421,40,112,0.357,24,40,0.6,0.553,11,14,0.786,18,92,110,18,15,35,20,48,179
2019,Allen Crabbe\crabbal01,SG,27,TOT,37,1,653,63,177,0.356,36,119,0.303,27,58,0.466,0.458,10,14,0.714,11,66,77,33,15,4,17,47,172
2019,Allen Crabbe\crabbal01,SG,27,ATL,28,1,522,52,143,0.364,30,93,0.323,22,50,0.44,0.469,9,12,0.75,10,55,65,28,15,4,12,36,143
2019,Allen Crabbe\crabbal01,SG,27,MIN,9,0,131,11,34,0.324,6,26,0.231,5,8,0.625,0.412,1,2,0.5,1,11,12,5,0,0,5,11,29
2019,Torrey Craig\craigto01,SF,29,DEN,50,19,869,96,208,0.462,36,109,0.33,60,99,0.606,0.548,20,31,0.645,48,108,156,34,18,32,22,112,248
2019,Jae Crowder\crowdja01,SF,29,TOT,58,46,1695,197,513,0.384,113,355,0.318,84,158,0.532,0.494,95,121,0.785,48,305,353,151,67,21,62,126,602
2019,Jae Crowder\crowdja01,SF,29,MEM,45,45,1322,147,399,0.368,78,266,0.293,69,133,0.519,0.466,75,95,0.789,40,237,277,125,47,14,54,85,447
2019,Jae Crowder\crowdja01,SF,29,MIA,13,1,373,50,114,0.439,35,89,0.393,15,25,0.6,0.592,20,26,0.769,8,68,76,26,20,7,8,41,155
2019,Jarrett Culver\culveja01,SG,20,MIN,63,35,1506,230,569,0.404,66,221,0.299,164,348,0.471,0.462,54,117,0.462,70,142,212,110,57,38,81,125,580
2019,Seth Curry\curryse01,SG,29,DAL,59,20,1448,266,532,0.5,136,300,0.453,130,232,0.56,0.628,74,88,0.841,26,113,139,119,36,8,60,101,742
2019,Stephen Curry\curryst01,PG,31,GSW,5,5,139,33,82,0.402,12,49,0.245,21,33,0.636,0.476,26,26,1,4,22,26,33,5,2,16,11,104
2019,Troy Daniels\danietr01,SG,28,TOT,42,0,457,62,159,0.39,40,113,0.354,22,46,0.478,0.516,10,16,0.625,12,34,46,14,8,3,9,30,174
2019,Troy Daniels\danietr01,SG,28,LAL,41,0,456,62,158,0.392,40,112,0.357,22,46,0.478,0.519,10,16,0.625,12,34,46,14,8,3,9,30,174
2019,Troy Daniels\danietr01,SG,28,DEN,1,0,1,0,1,0,0,1,0,0,0,,0,0,0,,0,0,0,0,0,0,0,0,0
2019,Anthony Davis\davisan02,PF,26,LAL,55,55,1889,508,994,0.511,65,194,0.335,443,800,0.554,0.544,386,457,0.845,124,393,517,172,82,134,135,138,1467
2019,Ed Davis\davised01,C,30,UTA,25,0,268,14,34,0.412,0,0,,14,34,0.412,0.412,5,11,0.455,29,66,95,8,10,9,13,55,33
2019,Terence Davis\daviste02,SG,22,TOR,64,2,1087,181,391,0.463,88,222,0.396,93,169,0.55,0.575,45,52,0.865,46,171,217,107,32,12,65,104,495
2019,Dewayne Dedmon\dedmode01,C,30,TOT,44,18,774,102,255,0.4,22,107,0.206,80,148,0.541,0.443,30,36,0.833,60,189,249,22,25,41,57,133,256
2019,Dewayne Dedmon\dedmode01,C,30,SAC,34,10,541,69,171,0.404,14,71,0.197,55,100,0.55,0.444,23,28,0.821,46,121,167,15,15,26,47,93,175
2019,Dewayne Dedmon\dedmode01,C,30,ATL,10,8,233,33,84,0.393,8,36,0.222,25,48,0.521,0.44,7,8,0.875,14,68,82,7,10,15,10,40,81
2019,Matthew Dellavedova\dellama01,PG,29,CLE,57,4,821,62,175,0.354,21,91,0.231,41,84,0.488,0.414,32,37,0.865,18,57,75,180,20,2,59,78,177
2019,DeMar DeRozan\derozde01,SF,30,SAS,61,61,2091,503,956,0.526,8,30,0.267,495,926,0.535,0.53,338,401,0.843,39,305,344,340,62,14,147,164,1352
2019,Cheick Diallo\diallch01,C,23,PHO,44,2,467,89,137,0.65,1,2,0.5,88,135,0.652,0.653,32,37,0.865,28,99,127,22,10,12,30,54,211
2019,Hamidou Diallo\diallha01,SF,21,OKC,38,3,699,99,219,0.452,7,35,0.2,92,184,0.5,0.468,28,45,0.622,29,93,122,22,28,8,37,82,233
2019,Gorgui Dieng\dienggo01,C,30,TOT,58,17,1012,158,343,0.461,51,142,0.359,107,201,0.532,0.535,61,83,0.735,87,249,336,71,48,56,55,112,428
2019,Gorgui Dieng\dienggo01,C,30,MIN,46,17,778,124,277,0.448,46,120,0.383,78,157,0.497,0.531,47,59,0.797,73,183,256,58,37,42,44,89,341
2019,Gorgui Dieng\dienggo01,C,30,MEM,12,0,234,34,66,0.515,5,22,0.227,29,44,0.659,0.553,14,24,0.583,14,66,80,13,11,14,11,23,87
2019,Spencer Dinwiddie\dinwisp01,SG,26,BRK,64,49,1994,424,1021,0.415,123,400,0.308,301,621,0.485,0.476,347,446,0.778,32,189,221,432,40,21,174,180,1318
2019,Donte DiVincenzo\divindo01,SG,23,MIL,59,22,1362,209,452,0.462,76,221,0.344,133,231,0.576,0.546,60,78,0.769,59,230,289,136,80,18,72,97,554
2019,Luka Dončić\doncilu01,PG,20,DAL,54,54,1799,512,1111,0.461,156,491,0.318,356,620,0.574,0.531,369,491,0.752,69,433,502,470,59,10,227,134,1549
2019,Luguentz Dort\dortlu01,SG,20,OKC,29,21,637,65,157,0.414,22,73,0.301,43,84,0.512,0.484,28,36,0.778,15,39,54,21,23,2,15,78,180
2019,Damyean Dotson\dotsoda01,SG,25,NYK,48,0,836,120,290,0.414,59,163,0.362,61,127,0.48,0.516,22,33,0.667,10,81,91,57,23,4,21,44,321
2019,Sekou Doumbouya\doumbse01,SF,19,DET,38,19,754,92,236,0.39,28,98,0.286,64,138,0.464,0.449,31,46,0.674,20,98,118,19,20,8,35,80,243
2019,PJ Dozier\doziepj01,PG,23,DEN,21,0,234,36,91,0.396,7,28,0.25,29,63,0.46,0.434,7,11,0.636,5,25,30,29,7,5,11,27,86
2019,Goran Dragić\dragigo01,PG,33,MIA,54,1,1531,290,663,0.437,118,313,0.377,172,350,0.491,0.526,170,221,0.769,26,140,166,273,31,8,133,105,868
2019,Andre Drummond\drumman01,C,26,TOT,57,56,1879,418,784,0.533,5,35,0.143,413,749,0.551,0.536,169,294,0.575,250,614,864,152,109,93,203,201,1010
2019,Andre Drummond\drumman01,C,26,DET,49,48,1654,360,679,0.53,1,21,0.048,359,658,0.546,0.531,149,255,0.584,226,549,775,138,97,82,174,176,870
2019,Andre Drummond\drumman01,C,26,CLE,8,8,225,58,105,0.552,4,14,0.286,54,91,0.593,0.571,20,39,0.513,24,65,89,14,12,11,29,25,140
2019,Jared Dudley\dudleja01,SF,34,LAL,40,1,311,20,50,0.4,16,34,0.471,4,16,0.25,0.56,2,2,1,5,38,43,19,12,3,6,36,58
2019,Kris Dunn\dunnkr01,PG,25,CHI,51,32,1269,152,342,0.444,29,112,0.259,123,230,0.535,0.487,40,54,0.741,23,163,186,173,101,17,68,158,373
2019,Carsen Edwards\edwarca01,SG,21,BOS,35,0,316,37,113,0.327,21,68,0.309,16,45,0.356,0.42,11,13,0.846,6,37,43,22,10,3,15,33,106
2019,Henry Ellenson\ellenhe01,PF,23,BRK,5,0,15,1,7,0.143,0,4,0,1,3,0.333,0.143,0,0,,2,4,6,1,0,0,0,1,2
2019,Wayne Ellington\ellinwa01,SG,32,NYK,36,1,558,61,174,0.351,50,143,0.35,11,31,0.355,0.494,11,13,0.846,4,61,65,44,13,4,18,41,183
2019,Joel Embiid\embiijo01,C,25,PHI,44,44,1329,332,701,0.474,56,161,0.348,276,540,0.511,0.514,311,382,0.814,122,398,520,137,38,58,135,151,1031
2019,James Ennis\ennisja01,SF,29,TOT,61,10,1053,128,294,0.435,47,139,0.338,81,155,0.523,0.515,63,78,0.808,61,138,199,54,29,20,43,109,366
2019,James Ennis\ennisja01,SF,29,PHI,49,0,776,100,226,0.442,37,106,0.349,63,120,0.525,0.524,48,61,0.787,48,102,150,41,23,14,31,85,285
2019,James Ennis\ennisja01,SF,29,ORL,12,10,277,28,68,0.412,10,33,0.303,18,35,0.514,0.485,15,17,0.882,13,36,49,13,6,6,12,24,81
2019,Drew Eubanks\eubandr01,PF,22,SAS,14,3,130,21,28,0.75,1,1,1,20,27,0.741,0.768,8,11,0.727,8,27,35,5,2,6,10,21,51
2019,Jacob Evans\evansja02,SG,22,TOT,29,1,418,45,134,0.336,13,39,0.333,32,95,0.337,0.384,25,29,0.862,9,32,41,31,11,12,25,41,128
2019,Jacob Evans\evansja02,SG,22,GSW,27,1,414,45,133,0.338,13,38,0.342,32,95,0.337,0.387,25,29,0.862,9,32,41,31,11,12,25,41,128
2019,Jacob Evans\evansja02,SG,22,MIN,2,0,4,0,1,0,0,1,0,0,0,,0,0,0,,0,0,0,0,0,0,0,0,0
2019,Dante Exum\exumda01,SG,24,TOT,35,1,485,56,119,0.471,15,43,0.349,41,76,0.539,0.534,32,43,0.744,12,55,67,40,13,8,31,38,159
2019,Dante Exum\exumda01,SG,24,UTA,11,0,83,10,23,0.435,2,6,0.333,8,17,0.471,0.478,2,2,1,3,9,12,7,1,2,10,8,24
2019,Dante Exum\exumda01,SG,24,CLE,24,1,402,46,96,0.479,13,37,0.351,33,59,0.559,0.547,30,41,0.732,9,46,55,33,12,6,21,30,135
2019,Tacko Fall\fallta01,C,24,BOS,6,0,24,9,12,0.75,0,0,,9,12,0.75,0.75,1,3,0.333,0,11,11,0,0,2,3,5,19
2019,Derrick Favors\favorde01,C,28,NOP,45,43,1089,189,305,0.62,1,7,0.143,188,298,0.631,0.621,36,62,0.581,147,298,445,75,25,44,51,99,415
2019,Cristiano Felício\feliccr01,PF,27,CHI,22,0,386,34,54,0.63,0,2,0,34,52,0.654,0.63,18,23,0.783,55,47,102,16,10,2,18,34,86
2019,Terrance Ferguson\fergute01,SF,21,OKC,50,37,1170,74,199,0.372,46,155,0.297,28,44,0.636,0.487,15,19,0.789,23,50,73,45,26,16,30,144,209
2019,Bruno Fernando\fernabr01,C,21,ATL,56,13,713,103,199,0.518,5,37,0.135,98,162,0.605,0.53,29,51,0.569,67,131,198,49,18,17,42,107,240
2019,Yogi Ferrell\ferreyo01,PG,26,SAC,44,0,484,67,169,0.396,19,69,0.275,48,100,0.48,0.453,32,37,0.865,6,42,48,59,14,4,25,31,185
2019,Dorian Finney-Smith\finnedo01,PF,26,DAL,64,61,1898,214,457,0.468,99,265,0.374,115,192,0.599,0.577,70,97,0.722,125,227,352,97,44,37,63,154,597
2019,Bryn Forbes\forbebr01,SG,26,SAS,63,62,1579,242,581,0.417,148,381,0.388,94,200,0.47,0.544,75,90,0.833,12,114,126,108,33,0,57,113,707
2019,Evan Fournier\fournev01,SG,27,ORL,61,61,1931,408,869,0.47,165,406,0.406,243,463,0.525,0.564,168,205,0.82,17,140,157,193,70,14,120,147,1149
2019,De'Aaron Fox\foxde01,PG,22,SAC,45,43,1426,329,692,0.475,47,153,0.307,282,539,0.523,0.509,215,306,0.703,30,151,181,304,64,23,141,129,920
2019,Melvin Frazier\frazime01,SG,23,ORL,15,0,51,6,17,0.353,4,7,0.571,2,10,0.2,0.471,2,4,0.5,1,3,4,1,4,2,3,8,18
2019,Michael Frazier\frazimi01,SG,25,HOU,8,0,66,4,11,0.364,2,8,0.25,2,3,0.667,0.455,4,6,0.667,1,2,3,1,2,0,2,13,14
2019,Tim Frazier\fraziti01,PG,29,DET,27,11,355,34,94,0.362,10,30,0.333,24,64,0.375,0.415,19,24,0.792,9,24,33,93,14,4,36,42,97
2019,Markelle Fultz\fultzma01,PG,21,ORL,64,59,1813,320,676,0.473,30,118,0.254,290,558,0.52,0.496,102,141,0.723,35,178,213,334,83,10,131,126,772
2019,Wenyen Gabriel\gabriwe01,PF,22,TOT,28,1,210,20,46,0.435,6,20,0.3,14,26,0.538,0.5,14,20,0.7,18,28,46,8,10,6,16,35,60
2019,Wenyen Gabriel\gabriwe01,PF,22,SAC,11,0,61,6,17,0.353,1,8,0.125,5,9,0.556,0.382,6,10,0.6,4,6,10,3,3,2,5,7,19
2019,Wenyen Gabriel\gabriwe01,PF,22,POR,17,1,149,14,29,0.483,5,12,0.417,9,17,0.529,0.569,8,10,0.8,14,22,36,5,7,4,11,28,41
2019,Daniel Gafford\gaffoda01,C,21,CHI,43,7,609,94,134,0.701,0,0,,94,134,0.701,0.701,32,60,0.533,52,54,106,21,13,56,29,98,220
2019,Danilo Gallinari\gallida01,PF,31,OKC,55,55,1690,329,749,0.439,165,403,0.409,164,346,0.474,0.549,234,264,0.886,32,270,302,113,40,4,70,66,1057
2019,Langston Galloway\gallola01,SG,28,DET,66,6,1702,236,542,0.435,132,331,0.399,104,211,0.493,0.557,73,85,0.859,33,116,149,101,48,11,40,96,677
2019,Darius Garland\garlada01,PG,20,CLE,59,59,1824,280,699,0.401,105,296,0.355,175,403,0.434,0.476,63,72,0.875,27,84,111,229,42,4,151,92,728
2019,Marc Gasol\gasolma01,C,35,TOR,36,35,990,99,236,0.419,51,127,0.402,48,109,0.44,0.528,26,36,0.722,29,199,228,124,28,33,43,101,275
2019,Rudy Gay\gayru01,PF,33,SAS,60,5,1287,222,502,0.442,58,185,0.314,164,317,0.517,0.5,99,113,0.876,56,266,322,101,26,28,78,89,601
2019,Paul George\georgpa01,SF,29,LAC,42,42,1222,291,674,0.432,133,333,0.399,158,341,0.463,0.53,165,187,0.882,22,219,241,162,56,20,113,101,880
2019,Taj Gibson\gibsota01,C,34,NYK,62,56,1025,167,286,0.584,4,14,0.286,163,272,0.599,0.591,41,56,0.732,111,156,267,52,27,30,47,122,379
2019,Harry Giles\gilesha01,PF,21,SAC,38,17,579,116,207,0.56,0,0,,116,207,0.56,0.56,33,43,0.767,33,126,159,49,21,14,35,100,265
2019,Shai Gilgeous-Alexander\gilgesh01,SG,21,OKC,63,63,2214,442,935,0.473,78,222,0.351,364,713,0.511,0.514,254,317,0.801,45,339,384,208,70,45,117,108,1216
2019,Rudy Gobert\goberru01,C,27,UTA,62,62,2142,353,506,0.698,0,0,,353,506,0.698,0.698,228,367,0.621,211,639,850,93,47,124,120,196,934
2019,Brandon Goodwin\goodwbr01,PG,24,ATL,34,1,430,76,190,0.4,26,87,0.299,50,103,0.485,0.468,28,30,0.933,11,61,72,51,12,4,29,43,206
2019,Aaron Gordon\gordoaa01,PF,24,ORL,58,58,1914,314,726,0.433,68,226,0.301,246,500,0.492,0.479,137,203,0.675,103,338,441,215,50,36,94,116,833
2019,Eric Gordon\gordoer01,SG,31,HOU,34,13,972,162,438,0.37,92,288,0.319,70,150,0.467,0.475,78,103,0.757,8,57,65,52,22,12,36,68,494
2019,Devonte' Graham\grahade01,PG,24,CHO,63,53,2211,368,963,0.382,218,585,0.373,150,378,0.397,0.495,191,233,0.82,42,170,212,471,62,15,181,115,1145
2019,Treveon Graham\grahatr01,SG,26,TOT,55,20,929,87,242,0.36,33,120,0.275,54,122,0.443,0.428,36,56,0.643,51,99,150,45,24,6,29,102,243
2019,Treveon Graham\grahatr01,SG,26,MIN,33,20,663,62,175,0.354,20,83,0.241,42,92,0.457,0.411,27,37,0.73,29,71,100,30,17,2,19,66,171
2019,Treveon Graham\grahatr01,SG,26,ATL,22,0,266,25,67,0.373,13,37,0.351,12,30,0.4,0.47,9,19,0.474,22,28,50,15,7,4,10,36,72
2019,Jerami Grant\grantje01,PF,25,DEN,64,22,1676,263,558,0.471,88,220,0.4,175,338,0.518,0.55,128,172,0.744,53,174,227,79,44,52,55,141,742
2019,Josh Gray\grayjo01,PG,26,NOP,2,0,23,1,2,0.5,0,0,,1,2,0.5,0.5,0,0,,1,1,2,2,0,0,5,1,2
2019,Danny Green\greenda02,SG,32,LAL,61,61,1529,178,425,0.419,113,299,0.378,65,126,0.516,0.552,32,44,0.727,44,162,206,86,76,29,54,129,501
2019,Draymond Green\greendr01,PF,29,GSW,43,43,1222,123,316,0.389,36,129,0.279,87,187,0.465,0.446,63,83,0.759,23,243,266,266,59,33,98,110,345
2019,JaMychal Green\greenja01,PF,29,LAC,55,0,1130,125,302,0.414,74,204,0.363,51,98,0.52,0.536,32,44,0.727,75,273,348,43,25,20,45,146,356
2019,Javonte Green\greenja02,SF,26,BOS,44,1,414,49,98,0.5,6,23,0.261,43,75,0.573,0.531,23,36,0.639,18,62,80,23,23,7,18,37,127
2019,Jeff Green\greenje02,PF,33,TOT,40,2,754,116,261,0.444,48,138,0.348,68,123,0.553,0.536,57,73,0.781,23,90,113,32,21,15,36,65,337
2019,Jeff Green\greenje02,PF,33,UTA,30,2,553,75,195,0.385,34,104,0.327,41,91,0.451,0.472,49,63,0.778,14,67,81,20,12,10,27,46,233
2019,Jeff Green\greenje02,PF,33,HOU,10,0,201,41,66,0.621,14,34,0.412,27,32,0.844,0.727,8,10,0.8,9,23,32,12,9,5,9,19,104
2019,Blake Griffin\griffbl01,PF,30,DET,18,18,512,88,250,0.352,27,111,0.243,61,139,0.439,0.406,76,98,0.776,17,67,84,59,7,7,40,27,279
2019,Marko Guduric\gudurma01,SG,24,MEM,42,0,476,61,154,0.396,25,81,0.309,36,73,0.493,0.477,23,25,0.92,14,57,71,45,12,8,36,34,170
2019,Kyle Guy\guyky01,SG,22,SAC,2,0,4,1,2,0.5,0,1,0,1,1,1,0.5,0,0,,0,0,0,0,0,0,0,0,2
2019,Rui Hachimura\hachiru01,PF,21,WAS,41,41,1217,218,456,0.478,20,73,0.274,198,383,0.517,0.5,92,111,0.829,63,185,248,70,34,7,41,89,548
2019,Devon Hall\hallde01,SG,24,OKC,5,0,20,1,5,0.2,0,2,0,1,3,0.333,0.2,3,4,0.75,0,1,1,3,0,0,1,1,5
2019,Donta Hall\halldo01,PF,22,DET,4,0,48,1,4,0.25,0,0,,1,4,0.25,0.25,4,6,0.667,6,9,15,2,1,1,2,9,6
2019,Dusty Hannahs\hannadu01,SG,26,MEM,2,0,13,4,9,0.444,2,3,0.667,2,6,0.333,0.556,2,2,1,0,1,1,0,0,0,0,1,12
2019,Tim Hardaway Jr.\hardati02,SG,27,DAL,63,50,1815,346,792,0.437,185,455,0.407,161,337,0.478,0.554,121,151,0.801,23,175,198,124,39,5,61,105,998
2019,James Harden\hardeja01,SG,30,HOU,61,61,2241,603,1386,0.435,271,769,0.352,332,617,0.538,0.533,619,719,0.861,64,324,388,450,106,53,273,206,2096
2019,Maurice Harkless\harklma01,SF,26,TOT,62,48,1427,142,283,0.502,34,98,0.347,108,185,0.584,0.562,39,66,0.591,55,185,240,68,58,33,53,148,357
2019,Maurice Harkless\harklma01,SF,26,LAC,50,38,1141,112,217,0.516,27,73,0.37,85,144,0.59,0.578,24,42,0.571,47,153,200,48,49,30,46,120,275
2019,Maurice Harkless\harklma01,SF,26,NYK,12,10,286,30,66,0.455,7,25,0.28,23,41,0.561,0.508,15,24,0.625,8,32,40,20,9,3,7,28,82
2019,Jared Harper\harpeja01,PG,22,PHO,3,0,8,1,4,0.25,0,2,0,1,2,0.5,0.25,0,0,,0,0,0,0,0,0,0,0,2
2019,Montrezl Harrell\harremo01,C,26,LAC,63,2,1749,471,812,0.58,0,18,0,471,794,0.593,0.58,231,351,0.658,163,282,445,107,39,72,108,146,1173
2019,Gary Harris\harriga01,SG,25,DEN,56,55,1780,218,519,0.42,70,210,0.333,148,309,0.479,0.487,75,92,0.815,26,137,163,118,76,14,60,116,581
2019,Joe Harris\harrijo01,SF,28,BRK,63,63,1946,332,705,0.471,152,369,0.412,180,336,0.536,0.579,62,83,0.747,60,212,272,130,38,16,93,138,878
2019,Tobias Harris\harrito02,PF,27,PHI,65,65,2243,494,1046,0.472,117,323,0.362,377,723,0.521,0.528,154,191,0.806,54,386,440,205,49,35,97,148,1259
2019,Shaquille Harrison\harrish01,SF,26,CHI,43,10,484,77,165,0.467,16,42,0.381,61,123,0.496,0.515,39,50,0.78,22,64,86,49,34,19,19,55,209
2019,Josh Hart\hartjo01,SF,24,NOP,57,14,1563,200,481,0.416,111,325,0.342,89,156,0.571,0.531,68,91,0.747,54,316,370,94,59,21,65,144,579
2019,Isaiah Hartenstein\harteis01,C,21,HOU,23,2,266,44,67,0.657,0,5,0,44,62,0.71,0.657,19,28,0.679,29,61,90,18,9,12,16,41,107
2019,Udonis Haslem\hasleud01,PF,39,MIA,3,0,21,1,6,0.167,0,2,0,1,4,0.25,0.167,3,4,0.75,0,8,8,1,0,0,0,3,5
2019,Jaxson Hayes\hayesja02,C,19,NOP,56,12,951,155,235,0.66,1,4,0.25,154,231,0.667,0.662,109,173,0.63,82,141,223,51,23,53,41,142,420
2019,Gordon Hayward\haywago01,SF,29,BOS,45,45,1501,305,607,0.502,74,189,0.392,231,418,0.553,0.563,94,111,0.847,45,249,294,185,35,20,79,81,778
2019,John Henson\hensojo01,PF,29,TOT,40,8,600,95,171,0.556,8,36,0.222,87,135,0.644,0.579,23,46,0.5,46,116,162,54,24,42,36,78,221
2019,John Henson\hensojo01,PF,29,CLE,29,2,412,61,120,0.508,6,31,0.194,55,89,0.618,0.533,17,33,0.515,32,82,114,43,16,32,21,55,145
2019,John Henson\hensojo01,PF,29,DET,11,6,188,34,51,0.667,2,5,0.4,32,46,0.696,0.686,6,13,0.462,14,34,48,11,8,10,15,23,76
2019,Dewan Hernandez\hernade01,C,23,TOR,4,0,11,1,5,0.2,0,1,0,1,4,0.25,0.2,2,2,1,2,5,7,0,1,0,1,6,4
2019,Juan Hernangómez\hernaju01,PF,24,TOT,48,14,833,100,247,0.405,44,129,0.341,56,118,0.475,0.494,44,71,0.62,43,154,197,40,19,9,32,64,288
2019,Juan Hernangómez\hernaju01,PF,24,DEN,34,0,422,38,110,0.345,15,60,0.25,23,50,0.46,0.414,16,25,0.64,24,71,95,22,5,5,18,29,107
2019,Juan Hernangómez\hernaju01,PF,24,MIN,14,14,411,62,137,0.453,29,69,0.42,33,68,0.485,0.558,28,46,0.609,19,83,102,18,14,4,14,35,181
2019,Willy Hernangómez\hernawi01,C,25,CHO,31,0,375,74,139,0.532,5,22,0.227,69,117,0.59,0.55,37,59,0.627,43,91,134,29,10,7,30,32,190
2019,Tyler Herro\herroty01,SG,20,MIA,47,6,1280,220,532,0.414,99,253,0.391,121,279,0.434,0.507,66,79,0.835,14,173,187,91,30,7,72,59,605
2019,Kevin Hervey\herveke01,PF,23,OKC,7,0,19,1,11,0.091,0,8,0,1,3,0.333,0.091,0,0,,0,2,2,1,0,0,0,1,2
2019,Mario Hezonja\hezonma01,PF,24,POR,47,4,767,81,189,0.429,21,64,0.328,60,125,0.48,0.484,42,51,0.824,26,136,162,42,28,9,37,92,225
2019,Buddy Hield\hieldbu01,SG,27,SAC,64,44,2045,456,1062,0.429,244,618,0.395,212,444,0.477,0.544,112,131,0.855,57,249,306,197,60,17,150,150,1268
2019,George Hill\hillge01,PG,33,MIL,52,0,1103,178,336,0.53,73,152,0.48,105,184,0.571,0.638,69,83,0.831,45,109,154,151,42,4,49,75,498
2019,Solomon Hill\hillso01,SF,28,TOT,54,4,992,100,248,0.403,59,156,0.378,41,92,0.446,0.522,30,42,0.714,27,127,154,98,36,12,47,78,289
2019,Solomon Hill\hillso01,SF,28,MEM,48,3,901,96,233,0.412,56,147,0.381,40,86,0.465,0.532,26,38,0.684,24,120,144,94,31,7,40,73,274
2019,Solomon Hill\hillso01,SF,28,MIA,6,1,91,4,15,0.267,3,9,0.333,1,6,0.167,0.367,4,4,1,3,7,10,4,5,5,7,5,15
2019,Jaylen Hoard\hoardja01,SF,20,POR,13,0,103,15,32,0.469,0,3,0,15,29,0.517,0.469,8,13,0.615,14,18,32,4,5,0,4,12,38
2019,Aaron Holiday\holidaa01,PG,23,IND,58,26,1368,202,496,0.407,80,203,0.394,122,293,0.416,0.488,62,72,0.861,21,111,132,193,45,13,75,102,546
2019,Jrue Holiday\holidjr01,SG,29,NOP,55,55,1922,421,931,0.452,115,322,0.357,306,609,0.502,0.514,119,170,0.7,70,198,268,378,92,44,158,125,1076
2019,Justin Holiday\holidju01,SG,30,IND,65,2,1617,190,432,0.44,122,288,0.424,68,144,0.472,0.581,46,59,0.78,30,176,206,87,75,42,40,119,548
2019,Rondae Hollis-Jefferson\holliro01,SF,25,TOR,52,5,998,139,295,0.471,2,17,0.118,137,278,0.493,0.475,95,129,0.736,102,152,254,90,44,22,49,105,375
2019,Richaun Holmes\holmeri01,C,26,SAC,39,33,1125,210,321,0.654,0,0,,210,321,0.654,0.654,80,100,0.8,118,207,325,39,39,55,49,152,500
2019,Rodney Hood\hoodro01,SF,27,POR,21,21,619,87,172,0.506,35,71,0.493,52,101,0.515,0.608,21,27,0.778,10,62,72,32,17,4,19,46,230
2019,Al Horford\horfoal01,C,33,PHI,60,57,1848,289,654,0.442,89,264,0.337,200,390,0.513,0.51,55,73,0.753,92,320,412,244,52,55,65,128,722
2019,Talen Horton-Tucker\hortota01,SG,19,LAL,2,0,5,0,1,0,0,1,0,0,0,,0,0,0,,0,0,0,2,1,0,0,0,0
2019,Danuel House\houseda01,SF,26,HOU,58,47,1739,206,482,0.427,113,311,0.363,93,171,0.544,0.545,68,85,0.8,56,190,246,78,64,32,49,119,593
2019,Dwight Howard\howardw01,C,34,LAL,62,2,1193,188,257,0.732,3,5,0.6,185,252,0.734,0.737,89,180,0.494,156,301,457,42,27,76,73,200,468
2019,William Howard\howarwi01,SG,26,HOU,2,0,13,0,4,0,0,4,0,0,0,,0,0,0,,0,2,2,1,0,0,1,1,0
2019,Kevin Huerter\huertke01,SG,21,ATL,56,48,1760,252,610,0.413,127,334,0.38,125,276,0.453,0.517,53,64,0.828,35,193,228,213,51,27,87,139,684
2019,De'Andre Hunter\huntede01,SF,22,ATL,63,62,2018,280,683,0.41,108,304,0.355,172,379,0.454,0.489,110,144,0.764,44,242,286,112,44,18,103,182,778
2019,Chandler Hutchison\hutchch01,SF,23,CHI,28,10,527,80,175,0.457,12,38,0.316,68,137,0.496,0.491,46,78,0.59,18,90,108,26,27,7,27,47,218
2019,Serge Ibaka\ibakase01,C,30,TOR,50,27,1377,323,623,0.518,66,166,0.398,257,457,0.562,0.571,89,119,0.748,104,310,414,73,24,42,100,138,801
2019,Andre Iguodala\iguodan01,SG,36,MIA,14,0,259,25,51,0.49,9,24,0.375,16,27,0.593,0.578,2,8,0.25,10,43,53,28,8,16,17,28,61
2019,Ersan İlyasova\ilyaser01,PF,32,MIL,56,8,895,137,290,0.472,46,124,0.371,91,166,0.548,0.552,62,75,0.827,60,216,276,47,23,14,33,87,382
2019,Joe Ingles\inglejo01,SF,32,UTA,64,37,1916,218,494,0.441,123,310,0.397,95,184,0.516,0.566,65,84,0.774,23,233,256,331,57,9,124,135,624
2019,Brandon Ingram\ingrabr01,PF,22,NOP,56,56,1919,469,1006,0.466,137,354,0.387,332,652,0.509,0.534,283,330,0.858,49,301,350,241,56,37,174,162,1358
2019,Kyrie Irving\irvinky01,PG,27,BRK,20,20,658,199,416,0.478,56,142,0.394,143,274,0.522,0.546,94,102,0.922,22,81,103,128,27,10,52,53,548
2019,Jonathan Isaac\isaacjo01,SF,22,ORL,32,32,949,149,322,0.463,30,91,0.33,119,231,0.515,0.509,56,73,0.767,57,165,222,44,50,78,47,79,384
2019,Wesley Iwundu\iwundwe01,SF,25,ORL,45,18,810,77,194,0.397,21,67,0.313,56,127,0.441,0.451,62,76,0.816,23,90,113,46,25,11,18,62,237
2019,Frank Jackson\jacksfr01,PG,21,NOP,51,1,656,99,257,0.385,39,120,0.325,60,137,0.438,0.461,48,64,0.75,19,52,71,41,15,4,43,67,285
2019,Jaren Jackson Jr.\jacksja02,C,20,MEM,54,54,1512,328,701,0.468,135,340,0.397,193,361,0.535,0.564,123,166,0.741,53,201,254,76,36,87,94,219,914
2019,Josh Jackson\jacksjo02,SG,22,MEM,18,0,357,68,155,0.439,23,72,0.319,45,83,0.542,0.513,29,44,0.659,11,47,58,31,18,9,25,39,188
2019,Justin Jackson\jacksju01,PF,24,DAL,58,2,929,124,311,0.399,45,151,0.298,79,160,0.494,0.471,36,44,0.818,27,115,142,49,12,10,12,58,329
2019,Reggie Jackson\jacksre01,PG,29,TOT,23,11,556,107,257,0.416,45,113,0.398,62,144,0.431,0.504,35,43,0.814,15,52,67,101,10,5,40,40,294
2019,Reggie Jackson\jacksre01,PG,29,DET,14,10,381,76,198,0.384,31,82,0.378,45,116,0.388,0.462,26,33,0.788,11,30,41,72,8,1,23,21,209
2019,Reggie Jackson\jacksre01,PG,29,LAC,9,1,175,31,59,0.525,14,31,0.452,17,28,0.607,0.644,9,10,0.9,4,22,26,29,2,4,17,19,85
2019,Justin James\jamesju01,SG,23,SAC,34,0,218,33,78,0.423,9,26,0.346,24,52,0.462,0.481,10,21,0.476,6,24,30,16,6,9,8,16,85
2019,LeBron James\jamesle01,PG,35,LAL,60,60,2094,586,1176,0.498,133,381,0.349,453,795,0.57,0.555,239,343,0.697,59,414,473,636,74,30,239,106,1544
2019,Amile Jefferson\jeffeam01,PF,26,ORL,18,0,74,5,14,0.357,0,0,,5,14,0.357,0.357,5,14,0.357,10,13,23,4,1,3,3,7,15
2019,DaQuan Jeffries\jeffrda01,SG,22,SAC,6,0,19,3,7,0.429,1,4,0.25,2,3,0.667,0.5,0,0,,1,0,1,1,1,0,0,3,7
2019,Ty Jerome\jeromty01,PG,22,PHO,28,0,315,37,106,0.349,13,47,0.277,24,59,0.407,0.41,11,14,0.786,6,35,41,43,14,3,18,28,98
2019,Alize Johnson\johnsal02,SF,23,IND,13,0,54,7,15,0.467,0,0,,7,15,0.467,0.467,4,6,0.667,7,11,18,2,0,0,3,6,18
2019,B.J. Johnson\johnsbj01,SF,24,ORL,8,0,46,5,18,0.278,1,6,0.167,4,12,0.333,0.306,2,2,1,1,5,6,2,2,0,3,0,13
2019,Cameron Johnson\johnsca02,PF,23,PHO,49,1,996,136,325,0.418,91,229,0.397,45,96,0.469,0.558,35,46,0.761,39,101,140,52,30,16,29,72,398
2019,James Johnson\johnsja01,PF,32,TOT,32,1,619,103,215,0.479,33,91,0.363,70,124,0.565,0.556,31,48,0.646,25,93,118,74,25,32,48,80,270
2019,James Johnson\johnsja01,PF,32,MIA,18,0,281,39,87,0.448,16,45,0.356,23,42,0.548,0.54,8,14,0.571,8,44,52,21,6,13,15,34,102
2019,James Johnson\johnsja01,PF,32,MIN,14,1,338,64,128,0.5,17,46,0.37,47,82,0.573,0.566,23,34,0.676,17,49,66,53,19,19,33,46,168
2019,Keldon Johnson\johnske04,SF,20,SAS,9,0,92,16,31,0.516,2,5,0.4,14,26,0.538,0.548,7,10,0.7,5,12,17,6,5,1,3,9,41
2019,Stanley Johnson\johnsst04,PF,23,TOR,20,0,96,8,31,0.258,2,13,0.154,6,18,0.333,0.29,5,6,0.833,3,19,22,8,4,2,8,10,23
2019,Tyler Johnson\johnsty01,SG,27,PHO,31,3,515,65,171,0.38,24,83,0.289,41,88,0.466,0.45,24,32,0.75,10,42,52,50,12,8,24,43,178
2019,Nikola Jokić\jokicni01,C,24,DEN,65,65,2101,512,969,0.528,71,226,0.314,441,743,0.594,0.565,218,268,0.813,155,508,663,446,77,43,202,200,1313
2019,Damian Jones\jonesda03,C,24,ATL,55,27,887,121,178,0.68,2,9,0.222,119,169,0.704,0.685,62,84,0.738,74,132,206,35,26,40,28,149,306
2019,Derrick Jones Jr.\jonesde02,SF,22,MIA,51,15,1249,166,323,0.514,34,126,0.27,132,197,0.67,0.567,88,113,0.779,57,156,213,57,54,36,27,114,454
2019,Tyus Jones\jonesty01,PG,23,MEM,65,6,1232,197,429,0.459,47,124,0.379,150,305,0.492,0.514,43,58,0.741,9,94,103,285,59,6,55,44,484
2019,DeAndre Jordan\jordade01,C,31,BRK,56,6,1234,191,287,0.666,0,0,,191,287,0.666,0.666,83,122,0.68,141,420,561,105,18,52,74,114,465
2019,Cory Joseph\josepco01,PG,28,SAC,64,22,1538,155,369,0.42,47,134,0.351,108,235,0.46,0.484,48,58,0.828,37,126,163,218,46,21,64,121,405
2019,Mfiondu Kabengele\kabenmf01,C,22,LAC,12,0,64,14,32,0.438,9,20,0.45,5,12,0.417,0.578,5,5,1,1,10,11,2,2,2,2,9,42
2019,Frank Kaminsky\kaminfr01,C,26,PHO,32,13,718,127,279,0.455,39,112,0.348,88,167,0.527,0.525,59,88,0.67,30,128,158,71,13,10,33,69,352
2019,Enes Kanter\kanteen01,C,27,BOS,51,6,891,176,311,0.566,1,7,0.143,175,304,0.576,0.568,63,89,0.708,141,253,394,49,21,38,52,85,416
2019,Luke Kennard\kennalu01,SG,23,DET,28,25,922,151,342,0.442,73,183,0.399,78,159,0.491,0.548,67,75,0.893,9,89,98,115,12,6,43,65,442
2019,Stanton Kidd\kiddst01,SF,27,UTA,4,0,15,0,3,0,0,1,0,0,2,0,0,0,0,,0,3,3,1,0,0,2,3,0
2019,Michael Kidd-Gilchrist\kiddgmi01,PF-SF,26,TOT,21,0,231,19,60,0.317,5,20,0.25,14,40,0.35,0.358,9,11,0.818,12,43,55,13,2,5,13,32,52
2019,Michael Kidd-Gilchrist\kiddgmi01,PF,26,CHO,12,0,160,18,53,0.34,5,17,0.294,13,36,0.361,0.387,7,9,0.778,9,26,35,10,0,3,7,18,48
2019,Michael Kidd-Gilchrist\kiddgmi01,SF,26,DAL,9,0,71,1,7,0.143,0,3,0,1,4,0.25,0.143,2,2,1,3,17,20,3,2,2,6,14,4
2019,Louis King\kinglo02,SF,20,DET,10,0,62,8,21,0.381,4,11,0.364,4,10,0.4,0.476,0,3,0,1,9,10,5,2,0,2,10,20
2019,Maxi Kleber\klebima01,C,28,DAL,66,21,1695,214,466,0.459,107,286,0.374,107,180,0.594,0.574,69,80,0.863,99,256,355,77,20,78,48,153,604
2019,Brandon Knight\knighbr03,PG,28,TOT,25,3,462,59,167,0.353,45,131,0.344,14,36,0.389,0.488,20,34,0.588,4,37,41,69,10,3,38,40,183
2019,Brandon Knight\knighbr03,PG,28,CLE,16,0,241,28,86,0.326,19,64,0.297,9,22,0.409,0.436,4,13,0.308,3,17,20,31,5,2,16,20,79
2019,Brandon Knight\knighbr03,PG,28,DET,9,3,221,31,81,0.383,26,67,0.388,5,14,0.357,0.543,16,21,0.762,1,20,21,38,5,1,22,20,104
2019,Kevin Knox\knoxke01,SF,20,NYK,65,4,1166,144,401,0.359,65,199,0.327,79,202,0.391,0.44,66,101,0.653,28,156,184,61,23,28,45,106,419
2019,John Konchar\konchjo01,SG,23,MEM,15,0,167,23,35,0.657,4,9,0.444,19,26,0.731,0.714,1,2,0.5,18,28,46,21,7,3,6,7,51
2019,Furkan Korkmaz\korkmfu01,SG,22,PHI,64,12,1398,222,514,0.432,126,317,0.397,96,197,0.487,0.554,53,72,0.736,16,132,148,70,36,15,52,89,623
2019,Luke Kornet\kornelu01,C,24,CHI,36,14,559,82,187,0.439,31,108,0.287,51,79,0.646,0.521,20,28,0.714,22,62,84,32,11,26,14,54,215
2019,Kyle Korver\korveky01,SF,38,MIL,50,0,833,111,259,0.429,86,207,0.415,25,52,0.481,0.595,28,34,0.824,14,90,104,61,21,12,42,68,336
2019,Rodions Kurucs\kurucro01,PF,21,BRK,39,4,501,60,134,0.448,25,65,0.385,35,69,0.507,0.541,17,28,0.607,18,79,97,33,17,3,35,66,162
2019,Kyle Kuzma\kuzmaky01,PF,24,LAL,54,7,1327,254,588,0.432,70,236,0.297,184,352,0.523,0.491,96,130,0.738,48,194,242,69,21,21,85,106,674
2019,Skal Labissière\labissk01,C,23,POR,33,1,567,81,147,0.551,3,13,0.231,78,134,0.582,0.561,25,33,0.758,65,104,169,42,7,31,30,89,190
2019,Jeremy Lamb\lambje01,SG,27,IND,46,42,1291,216,479,0.451,53,158,0.335,163,321,0.508,0.506,92,110,0.836,24,176,200,96,55,22,50,104,577
2019,Romeo Langford\langfro01,SG,20,BOS,27,1,298,24,64,0.375,5,23,0.217,19,41,0.463,0.414,16,23,0.696,14,18,32,6,8,6,9,29,69
2019,Zach LaVine\lavinza01,SG,24,CHI,60,60,2085,539,1199,0.45,184,484,0.38,355,715,0.497,0.526,268,334,0.802,41,248,289,254,88,28,206,131,1530
2019,Vic Law\lawvi01,SF,24,ORL,5,0,9,0,3,0,0,1,0,0,2,0,0,0,2,0,0,1,1,0,0,0,0,0,0
2019,Jake Layman\laymaja01,PF,25,MIN,23,2,505,81,179,0.453,24,72,0.333,57,107,0.533,0.52,24,32,0.75,17,40,57,15,17,10,24,47,210
2019,T.J. Leaf\leaftj01,PF,22,IND,25,1,193,30,69,0.435,5,14,0.357,25,55,0.455,0.471,7,12,0.583,21,43,64,6,8,3,7,18,72
2019,Jalen Lecque\lecquja01,PG,19,PHO,4,0,26,4,10,0.4,0,4,0,4,6,0.667,0.4,2,2,1,0,0,0,2,0,0,1,2,10
2019,Courtney Lee\leeco01,SG,34,DAL,24,9,345,40,82,0.488,21,47,0.447,19,35,0.543,0.616,6,7,0.857,7,25,32,12,18,6,11,33,107
2019,Damion Lee\leeda03,SG,27,GSW,49,36,1423,213,511,0.417,85,239,0.356,128,272,0.471,0.5,110,126,0.873,32,207,239,133,50,6,67,116,621
2019,Alex Len\lenal01,C,26,TOT,49,9,895,168,302,0.556,14,56,0.25,154,246,0.626,0.579,58,91,0.637,95,199,294,47,22,46,50,114,408
2019,Alex Len\lenal01,C,26,ATL,40,9,745,142,260,0.546,14,56,0.25,128,204,0.627,0.573,51,81,0.63,69,161,230,42,20,33,39,93,349
2019,Alex Len\lenal01,C,26,SAC,9,0,150,26,42,0.619,0,0,,26,42,0.619,0.619,7,10,0.7,26,38,64,5,2,13,11,21,59
2019,Kawhi Leonard\leonaka01,SF,28,LAC,51,51,1643,476,1016,0.469,107,292,0.366,369,724,0.51,0.521,311,350,0.889,52,321,373,254,92,31,140,98,1370
2019,Meyers Leonard\leoname01,C,27,MIA,49,49,987,116,223,0.52,51,119,0.429,65,104,0.625,0.635,17,26,0.654,27,221,248,53,13,15,35,103,300
2019,Caris LeVert\leverca01,SG,25,BRK,39,25,1131,252,609,0.414,72,189,0.381,180,420,0.429,0.473,116,161,0.72,40,119,159,159,44,7,98,72,692
2019,Damian Lillard\lillada01,PG,29,POR,58,58,2140,531,1162,0.457,226,573,0.394,305,589,0.518,0.554,389,438,0.888,30,220,250,453,59,21,168,98,1677
2019,Nassir Little\littlna01,PF,19,POR,48,5,573,65,151,0.43,14,59,0.237,51,92,0.554,0.477,28,44,0.636,31,77,108,22,13,14,15,72,172
2019,Kevon Looney\looneke01,C,23,GSW,20,4,262,29,79,0.367,1,14,0.071,28,65,0.431,0.373,9,12,0.75,28,38,66,20,12,6,12,34,68
2019,Brook Lopez\lopezbr01,C,31,MIL,61,60,1622,244,571,0.427,84,284,0.296,160,287,0.557,0.501,98,121,0.81,42,230,272,95,43,149,63,147,670
2019,Robin Lopez\lopezro01,C,31,MIL,60,4,862,137,273,0.502,33,96,0.344,104,177,0.588,0.562,23,43,0.535,52,94,146,41,10,41,54,80,330
2019,Kevin Love\loveke01,PF,31,CLE,56,56,1780,327,727,0.45,146,390,0.374,181,337,0.537,0.55,187,219,0.854,54,493,547,178,33,19,140,90,987
2019,Kyle Lowry\lowryky01,PG,33,TOR,52,52,1901,309,741,0.417,153,432,0.354,156,309,0.505,0.52,255,296,0.861,30,221,251,399,70,22,154,168,1026
2019,Timothé Luwawu-Cabarrot\luwawti01,SG,24,BRK,39,0,671,78,192,0.406,39,109,0.358,39,83,0.47,0.508,52,62,0.839,24,67,91,25,15,6,32,81,247
2019,Trey Lyles\lylestr01,PF,24,SAS,63,53,1271,153,343,0.446,65,168,0.387,88,175,0.503,0.541,33,45,0.733,71,290,361,69,28,28,39,98,404
2019,Daryl Macon\maconda01,SG,24,MIA,4,0,14,1,3,0.333,1,2,0.5,0,1,0,0.5,0,0,,0,0,0,1,0,0,2,1,3
2019,J.P. Macura\macurjp01,SG,24,CLE,1,0,1,0,0,,0,0,,0,0,,,0,0,,0,0,0,0,0,0,0,0,0
2019,Josh Magette\magetjo01,PG,30,ORL,8,0,38,5,15,0.333,1,4,0.25,4,11,0.364,0.367,1,2,0.5,1,5,6,5,3,1,5,4,12
2019,Ian Mahinmi\mahinia01,C,33,WAS,38,35,808,104,210,0.495,5,26,0.192,99,184,0.538,0.507,70,113,0.619,78,140,218,49,31,44,45,114,283
2019,Thon Maker\makerth01,C,22,DET,60,14,776,93,193,0.482,22,64,0.344,71,129,0.55,0.539,73,110,0.664,54,113,167,43,25,39,45,102,281
2019,Terance Mann\mannte01,SG,23,LAC,35,6,271,22,54,0.407,3,12,0.25,19,42,0.452,0.435,9,12,0.75,4,29,33,38,8,5,14,36,56
2019,Boban Marjanović\marjabo01,C,31,DAL,37,2,337,96,173,0.555,4,15,0.267,92,158,0.582,0.566,36,47,0.766,53,100,153,13,7,7,26,47,232
2019,Lauri Markkanen\markkla01,PF,22,CHI,50,50,1492,251,591,0.425,109,317,0.344,142,274,0.518,0.517,126,153,0.824,60,253,313,74,42,23,81,96,737
2019,Caleb Martin\martica02,SF,24,CHO,18,1,317,37,84,0.44,20,37,0.541,17,47,0.362,0.56,17,21,0.81,10,28,38,23,12,7,15,32,111
2019,Cody Martin\martico01,SF,24,CHO,48,3,903,89,207,0.43,18,77,0.234,71,130,0.546,0.473,42,65,0.646,38,120,158,95,39,9,44,78,238
2019,Jeremiah Martin\martije02,PG,23,BRK,3,0,16,1,5,0.2,0,1,0,1,4,0.25,0.2,0,0,,0,2,2,2,1,1,0,0,2
2019,Kelan Martin\martike03,SF,24,MIN,31,4,495,71,181,0.392,25,96,0.26,46,85,0.541,0.461,30,31,0.968,12,84,96,23,7,9,20,51,197
2019,Frank Mason III\masonfr01,PG,25,MIL,6,0,53,5,19,0.263,2,10,0.2,3,9,0.333,0.316,2,4,0.5,3,5,8,11,2,0,6,4,14
2019,Garrison Mathews\mathega01,SG,23,WAS,18,0,227,24,56,0.429,19,46,0.413,5,10,0.5,0.598,31,34,0.912,6,18,24,10,8,1,8,32,98
2019,Wesley Matthews\matthwe02,SG,33,MIL,62,62,1529,159,401,0.397,101,277,0.365,58,124,0.468,0.522,48,63,0.762,21,139,160,91,37,9,41,91,467
2019,Patrick McCaw\mccawpa01,SF,24,TOR,37,12,908,67,162,0.414,23,71,0.324,44,91,0.484,0.485,13,18,0.722,19,67,86,79,39,4,29,60,170
2019,CJ McCollum\mccolcj01,SG,28,POR,62,62,2229,549,1212,0.453,174,458,0.38,375,754,0.497,0.525,123,164,0.75,41,213,254,268,46,39,116,159,1395
2019,T.J. McConnell\mccontj01,PG,27,IND,63,3,1188,187,362,0.517,5,15,0.333,182,347,0.524,0.523,30,36,0.833,32,131,163,316,44,11,86,69,409
2019,Jalen McDaniels\mcdanja01,PF,22,CHO,16,0,293,33,70,0.471,9,24,0.375,24,46,0.522,0.536,14,17,0.824,15,50,65,13,8,3,11,36,89
2019,Doug McDermott\mcderdo01,PF,28,IND,62,0,1242,241,491,0.491,118,265,0.445,123,226,0.544,0.611,43,52,0.827,23,133,156,70,9,4,40,106,643
2019,JaVale McGee\mcgeeja01,C,32,LAL,61,61,1023,181,283,0.64,3,6,0.5,178,277,0.643,0.645,49,75,0.653,111,243,354,34,31,92,47,145,414
2019,Rodney McGruder\mcgruro01,SG,28,LAC,50,3,749,61,156,0.391,22,79,0.278,39,77,0.506,0.462,15,28,0.536,26,102,128,30,23,8,21,67,159
2019,Alfonzo McKinnie\mckinal01,SF,27,CLE,40,1,593,73,171,0.427,14,65,0.215,59,106,0.557,0.468,22,31,0.71,37,76,113,14,23,8,26,72,182
2019,Jordan McLaughlin\mclaujo01,PG,23,MIN,30,2,590,87,178,0.489,29,76,0.382,58,102,0.569,0.57,26,39,0.667,7,42,49,125,34,4,31,31,229
2019,Ben McLemore\mclembe01,SG,26,HOU,63,19,1437,209,470,0.445,154,390,0.395,55,80,0.688,0.609,47,62,0.758,20,119,139,54,38,12,46,130,619
2019,Jordan McRae\mcraejo01,SG,28,TOT,37,4,784,149,366,0.407,45,126,0.357,104,240,0.433,0.469,83,109,0.761,18,106,124,93,21,16,43,73,426
2019,Jordan McRae\mcraejo01,SG,28,WAS,29,4,654,133,317,0.42,40,106,0.377,93,211,0.441,0.483,64,83,0.771,17,87,104,82,19,15,38,61,370
2019,Jordan McRae\mcraejo01,SG,28,DEN,4,0,32,2,6,0.333,2,4,0.5,0,2,0,0.5,3,4,0.75,1,4,5,4,2,1,0,2,9
2019,Jordan McRae\mcraejo01,SG,28,DET,4,0,98,14,43,0.326,3,16,0.188,11,27,0.407,0.36,16,22,0.727,0,15,15,7,0,0,5,10,47
2019,Nicolò Melli\mellini01,C,29,NOP,52,6,889,123,278,0.442,65,180,0.361,58,98,0.592,0.559,44,60,0.733,37,120,157,67,30,19,42,105,355
2019,De'Anthony Melton\meltode01,PG,21,MEM,52,8,1011,148,353,0.419,37,117,0.316,111,236,0.47,0.472,87,106,0.821,37,156,193,157,65,18,78,92,420
2019,Chimezie Metu\metuch01,PF,22,SAS,16,0,73,20,35,0.571,0,1,0,20,34,0.588,0.571,6,8,0.75,10,16,26,6,1,4,5,4,46
2019,Khris Middleton\middlkh01,SF,28,MIL,55,52,1653,424,850,0.499,133,318,0.418,291,532,0.547,0.577,178,196,0.908,40,301,341,225,51,7,113,122,1159
2019,Eric Mika\mikaer01,PF,25,SAC,1,0,19,2,3,0.667,0,0,,2,3,0.667,0.667,2,2,1,2,5,7,0,0,0,0,5,6
2019,C.J. Miles\milescj01,SG,32,WAS,10,0,161,19,59,0.322,11,35,0.314,8,24,0.333,0.415,15,20,0.75,4,8,12,12,10,4,4,14,64
2019,Malcolm Miller\millema01,SF,26,TOR,25,1,125,8,24,0.333,6,19,0.316,2,5,0.4,0.458,1,6,0.167,1,13,14,8,4,2,3,12,23
2019,Patty Mills\millspa02,PG,31,SAS,63,1,1430,247,576,0.429,148,389,0.38,99,187,0.529,0.557,93,108,0.861,19,80,99,112,52,6,51,98,735
2019,Paul Millsap\millspa01,PF,34,DEN,44,41,1075,188,387,0.486,48,109,0.44,140,278,0.504,0.548,105,126,0.833,87,173,260,70,38,28,61,127,529
2019,Shake Milton\miltosh01,SG,23,PHI,32,16,611,108,217,0.498,48,106,0.453,60,111,0.541,0.608,39,51,0.765,11,57,68,71,19,6,38,69,303
2019,Donovan Mitchell\mitchdo01,SG,23,UTA,63,63,2165,560,1235,0.453,156,428,0.364,404,807,0.501,0.517,249,290,0.859,44,232,276,264,66,12,167,154,1525
2019,Naz Mitrou-Long\mitrona01,SG,26,IND,3,0,43,6,16,0.375,2,11,0.182,4,5,0.8,0.438,0,0,,0,6,6,7,1,1,2,1,14
2019,Adam Mokoka\mokokad01,SG,21,CHI,11,0,112,12,28,0.429,6,15,0.4,6,13,0.462,0.536,2,4,0.5,7,3,10,4,4,0,2,17,32
2019,Malik Monk\monkma01,SG,21,CHO,55,1,1169,212,488,0.434,58,204,0.284,154,284,0.542,0.494,82,100,0.82,27,130,157,114,25,16,77,74,564
2019,Matt Mooney\moonema01,SG,22,CLE,4,0,19,1,4,0.25,0,2,0,1,2,0.5,0.25,0,0,,0,3,3,1,2,1,0,1,2
2019,E'Twaun Moore\mooreet01,SG,30,NOP,51,5,958,174,410,0.424,60,160,0.375,114,250,0.456,0.498,29,43,0.674,29,94,123,73,28,10,38,77,437
2019,Ja Morant\moranja01,PG,20,MEM,59,59,1771,393,800,0.491,51,139,0.367,342,661,0.517,0.523,204,265,0.77,44,164,208,409,54,15,191,90,1041
2019,Juwan Morgan\morgaju01,PF,22,UTA,16,0,74,9,17,0.529,1,5,0.2,8,12,0.667,0.559,0,0,,5,14,19,2,0,1,3,7,19
2019,Marcus Morris\morrima03,SF-PF,30,TOT,55,55,1727,325,750,0.433,133,324,0.41,192,426,0.451,0.522,172,209,0.823,55,226,281,77,42,27,88,161,955
2019,Marcus Morris\morrima03,SF,30,NYK,43,43,1387,281,636,0.442,116,264,0.439,165,372,0.444,0.533,163,198,0.823,48,185,233,59,34,17,73,128,841
2019,Marcus Morris\morrima03,PF,30,LAC,12,12,340,44,114,0.386,17,60,0.283,27,54,0.5,0.461,9,11,0.818,7,41,48,18,8,10,15,33,114
2019,Markieff Morris\morrima02,PF,30,TOT,52,16,1106,189,425,0.445,81,210,0.386,108,215,0.502,0.54,65,83,0.783,34,165,199,74,28,15,75,120,524
2019,Markieff Morris\morrima02,PF,30,DET,44,16,988,175,389,0.45,75,189,0.397,100,200,0.5,0.546,61,79,0.772,24,149,173,69,26,11,70,104,486
2019,Markieff Morris\morrima02,PF,30,LAL,8,0,118,14,36,0.389,6,21,0.286,8,15,0.533,0.472,4,4,1,10,16,26,5,2,4,5,16,38
2019,Monte Morris\morrimo01,PG,24,DEN,65,8,1402,222,484,0.459,54,144,0.375,168,340,0.494,0.514,51,62,0.823,20,92,112,230,53,16,45,64,549
2019,Johnathan Motley\motlejo01,PF,24,LAC,13,0,41,11,15,0.733,1,1,1,10,14,0.714,0.767,5,7,0.714,3,7,10,8,3,0,5,6,28
2019,Emmanuel Mudiay\mudiaem01,PG,23,UTA,48,1,752,136,289,0.471,27,76,0.355,109,213,0.512,0.517,52,69,0.754,17,98,115,107,19,10,65,64,351
2019,Mychal Mulder\muldemy01,SG,25,GSW,7,3,204,26,67,0.388,16,52,0.308,10,15,0.667,0.507,9,12,0.75,3,20,23,8,2,1,5,20,77
2019,Dejounte Murray\murrade01,PG,23,SAS,58,50,1447,255,537,0.475,34,90,0.378,221,447,0.494,0.507,75,94,0.798,67,268,335,237,100,16,108,128,619
2019,Jamal Murray\murraja01,PG,22,DEN,55,55,1804,385,846,0.455,105,304,0.345,280,542,0.517,0.517,158,177,0.893,42,175,217,266,64,16,124,97,1033
2019,Džanan Musa\musadz01,SF,20,BRK,35,0,404,50,139,0.36,15,65,0.231,35,74,0.473,0.414,33,44,0.75,19,52,71,31,13,1,29,25,148
2019,Mike Muscala\muscami01,C,28,OKC,41,0,492,64,159,0.403,43,120,0.358,21,39,0.538,0.538,18,22,0.818,13,81,94,34,8,11,14,51,189
2019,Sviatoslav Mykhailiuk\mykhasv01,SF,22,DET,56,27,1265,166,405,0.41,115,285,0.404,51,120,0.425,0.552,57,70,0.814,17,87,104,106,41,4,61,87,504
2019,Abdel Nader\naderab01,SF,26,OKC,48,5,756,100,220,0.455,39,105,0.371,61,115,0.53,0.543,48,62,0.774,14,76,90,35,20,20,36,65,287
2019,Larry Nance Jr.\nancela02,C,27,CLE,56,10,1472,229,431,0.531,56,159,0.352,173,272,0.636,0.596,50,74,0.676,106,303,409,123,56,22,60,91,564
2019,Shabazz Napier\napiesh01,PG,28,TOT,51,30,1234,170,413,0.412,71,222,0.32,99,191,0.518,0.498,116,141,0.823,25,121,146,253,66,9,111,93,527
2019,Shabazz Napier\napiesh01,PG,28,MIN,36,22,856,114,283,0.403,47,159,0.296,67,124,0.54,0.486,72,88,0.818,17,93,110,187,40,7,76,62,347
2019,Shabazz Napier\napiesh01,PG,28,WAS,15,8,378,56,130,0.431,24,63,0.381,32,67,0.478,0.523,44,53,0.83,8,28,36,66,26,2,35,31,180
2019,Raul Neto\netora01,PG,27,PHI,49,3,565,79,175,0.451,28,71,0.394,51,104,0.49,0.531,26,31,0.839,11,41,52,77,22,5,42,43,212
2019,Malik Newman\newmama01,SG,22,CLE,1,0,4,0,2,0,0,1,0,0,1,0,0,2,2,1,0,0,0,0,0,0,1,0,2
2019,Georges Niang\niangge01,PF,26,UTA,58,0,772,120,265,0.453,77,185,0.416,43,80,0.538,0.598,19,22,0.864,12,97,109,35,13,5,26,63,336
2019,Nerlens Noel\noelne01,C,25,OKC,55,6,1014,174,254,0.685,1,3,0.333,173,251,0.689,0.687,75,98,0.765,82,189,271,53,56,82,54,143,424
2019,Zach Norvell\norveza01,SG,22,TOT,5,0,41,3,12,0.25,3,8,0.375,0,4,0,0.375,1,1,1,0,6,6,3,2,0,3,4,10
2019,Zach Norvell\norveza01,SG,22,LAL,2,0,5,0,1,0,0,0,,0,1,0,0,0,0,,0,1,1,0,0,0,0,0,0
2019,Zach Norvell\norveza01,SG,22,GSW,3,0,36,3,11,0.273,3,8,0.375,0,3,0,0.409,1,1,1,0,5,5,3,2,0,3,4,10
2019,Jaylen Nowell\nowelja01,SG,20,MIN,15,0,151,19,53,0.358,3,26,0.115,16,27,0.593,0.387,16,17,0.941,3,10,13,19,3,1,3,11,57
2019,Frank Ntilikina\ntilila01,PG,21,NYK,57,26,1187,131,333,0.393,44,137,0.321,87,196,0.444,0.459,51,59,0.864,23,98,121,172,54,16,71,142,357
2019,Kendrick Nunn\nunnke01,SG,24,MIA,62,62,1846,381,850,0.448,131,362,0.362,250,488,0.512,0.525,77,92,0.837,19,149,168,210,51,11,101,142,970
2019,David Nwaba\nwabada01,SF,27,BRK,20,0,268,37,71,0.521,12,28,0.429,25,43,0.581,0.606,18,27,0.667,8,37,45,8,11,12,8,32,104
2019,Royce O'Neale\onealro01,PF,26,UTA,64,55,1862,141,321,0.439,82,211,0.389,59,110,0.536,0.567,36,49,0.735,22,317,339,163,47,28,50,180,400
2019,Kyle O'Quinn\oquinky01,C,29,PHI,26,1,258,35,72,0.486,7,23,0.304,28,49,0.571,0.535,10,19,0.526,32,66,98,35,5,22,18,35,87
2019,Semi Ojeleye\ojelese01,PF,25,BOS,61,5,891,65,159,0.409,36,98,0.367,29,61,0.475,0.522,25,28,0.893,24,100,124,31,18,5,12,63,191
2019,Jahlil Okafor\okafoja01,C,24,NOP,28,9,424,88,144,0.611,1,2,0.5,87,142,0.613,0.615,37,58,0.638,46,73,119,36,7,19,36,63,214
2019,Elie Okobo\okoboel01,PG,22,PHO,54,3,707,72,181,0.398,25,71,0.352,47,110,0.427,0.467,46,67,0.687,16,72,88,113,24,4,38,53,215
2019,Josh Okogie\okogijo01,SG,21,MIN,62,28,1547,170,398,0.427,41,154,0.266,129,244,0.529,0.479,152,191,0.796,87,181,268,99,68,26,87,139,533
2019,KZ Okpala\okpalkz01,SF,20,MIA,5,0,26,3,5,0.6,0,1,0,3,4,0.75,0.6,1,2,0.5,1,4,5,1,2,1,1,2,7
2019,Victor Oladipo\oladivi01,SG,27,IND,13,10,337,63,161,0.391,21,69,0.304,42,92,0.457,0.457,32,41,0.78,7,34,41,39,11,3,28,21,179
2019,Kelly Olynyk\olynyke01,C,28,MIA,59,6,1089,151,317,0.476,80,185,0.432,71,132,0.538,0.603,70,82,0.854,37,222,259,97,38,18,63,144,452
2019,Miye Oni\onimi01,SG,22,UTA,5,0,11,0,2,0,0,1,0,0,1,0,0,0,0,,0,2,2,0,0,0,1,0,0
2019,Cedi Osman\osmande01,SF,24,CLE,65,65,1910,266,609,0.437,123,321,0.383,143,288,0.497,0.538,63,94,0.67,39,192,231,154,54,16,91,160,718
2019,Kelly Oubre Jr.\oubreke01,SF,24,PHO,56,55,1933,373,826,0.452,108,307,0.352,265,519,0.511,0.517,192,246,0.78,67,294,361,85,71,40,83,192,1046
2019,Tariq Owens\owensta01,PF,24,PHO,3,0,15,1,5,0.2,0,2,0,1,3,0.333,0.2,2,2,1,2,1,3,0,1,0,0,1,4
2019,Jeremy Pargo\pargoje01,PG,33,GSW,3,0,44,11,22,0.5,3,7,0.429,8,15,0.533,0.568,0,1,0,1,2,3,8,1,0,4,8,25
2019,Jabari Parker\parkeja01,PF,24,TOT,33,23,852,199,399,0.499,31,116,0.267,168,283,0.594,0.538,55,74,0.743,54,141,195,60,42,15,60,94,484
2019,Jabari Parker\parkeja01,PF,24,ATL,32,23,837,198,393,0.504,31,115,0.27,167,278,0.601,0.543,53,72,0.736,54,137,191,58,42,15,60,93,480
2019,Jabari Parker\parkeja01,PF,24,SAC,1,0,15,1,6,0.167,0,1,0,1,5,0.2,0.167,2,2,1,0,4,4,2,0,0,0,1,4
2019,Chandler Parsons\parsoch01,SF,31,ATL,5,0,54,5,18,0.278,4,14,0.286,1,4,0.25,0.389,0,0,,1,6,7,3,4,1,3,3,14
2019,Eric Paschall\pascher01,PF,23,GSW,60,26,1654,318,640,0.497,37,129,0.287,281,511,0.55,0.526,164,212,0.774,82,193,275,127,32,13,94,125,837
2019,Anžejs Pasečņiks\pasecan01,C,24,WAS,24,0,405,56,106,0.528,0,2,0,56,104,0.538,0.528,32,54,0.593,39,60,99,17,8,12,22,65,144
2019,Patrick Patterson\pattepa01,PF,30,LAC,51,18,607,76,188,0.404,55,142,0.387,21,46,0.457,0.551,27,34,0.794,30,91,121,31,6,3,18,41,234
2019,Justin Patton\pattoju01,C,22,OKC,5,0,24,4,10,0.4,1,4,0.25,3,6,0.5,0.45,0,0,,1,4,5,2,0,0,2,4,9
2019,Chris Paul\paulch01,PG,34,OKC,63,63,2003,394,805,0.489,101,279,0.362,293,526,0.557,0.552,225,250,0.9,21,289,310,426,98,9,137,139,1114
2019,Elfrid Payton\paytoel01,PG,25,NYK,45,36,1246,193,440,0.439,14,69,0.203,179,371,0.482,0.455,49,86,0.57,52,160,212,323,70,17,96,89,449
2019,Gary Payton II\paytoga02,PG,27,WAS,29,17,432,48,116,0.414,13,46,0.283,35,70,0.5,0.47,4,8,0.5,26,54,80,48,33,7,20,54,113
2019,Norvel Pelle\pelleno01,C,26,PHI,20,0,178,18,35,0.514,0,0,,18,35,0.514,0.514,6,12,0.5,16,44,60,7,1,25,13,39,42
2019,Theo Pinson\pinsoth01,SG,24,BRK,33,0,365,45,155,0.29,15,80,0.188,30,75,0.4,0.339,15,16,0.938,10,44,54,56,17,4,33,35,120
2019,Mason Plumlee\plumlma01,C,29,DEN,53,1,900,153,248,0.617,0,4,0,153,244,0.627,0.617,74,138,0.536,89,193,282,125,29,33,72,125,380
2019,Jakob Poeltl\poeltja01,C,24,SAS,58,10,965,135,218,0.619,0,0,,135,218,0.619,0.619,36,74,0.486,104,206,310,102,30,84,45,96,306
2019,Vincent Poirier\poirivi01,C,26,BOS,21,0,114,16,33,0.485,1,2,0.5,15,31,0.484,0.5,6,7,0.857,10,24,34,7,2,6,6,23,39
2019,Shamorie Ponds\pondssh01,PG,21,TOR,4,0,11,3,5,0.6,1,2,0.5,2,3,0.667,0.7,2,2,1,0,1,1,2,0,1,0,2,9
2019,Jordan Poole\poolejo01,SG,20,GSW,57,14,1274,167,502,0.333,74,265,0.279,93,237,0.392,0.406,95,119,0.798,9,109,118,134,35,10,74,94,503
2019,Kevin Porter Jr.\porteke02,SF,19,CLE,50,3,1162,186,421,0.442,53,158,0.335,133,263,0.506,0.505,73,101,0.723,22,140,162,109,46,14,93,135,498
2019,Michael Porter Jr.\portemi01,PF,21,DEN,48,1,670,141,285,0.495,43,102,0.422,98,183,0.536,0.57,33,43,0.767,53,146,199,35,20,19,35,75,358
2019,Otto Porter\porteot01,SF,26,CHI,14,9,331,62,140,0.443,24,62,0.387,38,78,0.487,0.529,19,27,0.704,13,35,48,25,15,6,11,31,167
2019,Bobby Portis\portibo01,C,24,NYK,66,5,1393,265,589,0.45,67,187,0.358,198,402,0.493,0.507,71,93,0.763,80,258,338,98,32,18,73,110,668
2019,Kristaps Porziņģis\porzikr01,PF,24,DAL,51,51,1597,339,808,0.42,126,361,0.349,213,447,0.477,0.498,177,228,0.776,89,394,483,89,36,106,84,157,981
2019,Dwight Powell\poweldw01,C,28,DAL,40,37,1061,146,229,0.638,10,39,0.256,136,190,0.716,0.659,74,111,0.667,75,152,227,59,34,22,36,102,376
2019,Norman Powell\powelno01,SG,26,TOR,44,23,1269,259,516,0.502,94,236,0.398,165,280,0.589,0.593,109,130,0.838,23,138,161,78,55,17,64,93,721
2019,Chasson Randle\randlch01,PG,26,GSW,3,0,40,0,4,0,0,2,0,0,2,0,0,5,6,0.833,0,2,2,5,2,0,0,3,5
2019,Julius Randle\randlju01,PF,25,NYK,64,64,2080,463,1006,0.46,64,231,0.277,399,775,0.515,0.492,258,352,0.733,151,471,622,198,51,22,193,178,1248
2019,Josh Reaves\reavejo02,SG,22,DAL,2,0,1,0,1,0,0,0,,0,1,0,0,0,0,,0,0,0,0,0,0,0,0,0
2019,Cam Reddish\reddica01,SF,20,ATL,58,34,1551,213,554,0.384,83,250,0.332,130,304,0.428,0.459,101,126,0.802,35,181,216,87,62,28,96,132,610
2019,J.J. Redick\redicjj01,SG,35,NOP,54,35,1425,251,558,0.45,156,345,0.452,95,213,0.446,0.59,147,163,0.902,9,131,140,108,19,9,65,86,805
2019,Naz Reid\reidna01,C,20,MIN,30,11,495,100,243,0.412,32,97,0.33,68,146,0.466,0.477,37,53,0.698,34,90,124,35,19,22,22,83,269
2019,Josh Richardson\richajo01,SG,26,PHI,48,46,1474,246,574,0.429,70,214,0.327,176,360,0.489,0.49,101,128,0.789,37,125,162,148,45,34,91,120,663
2019,Austin Rivers\riverau01,SG,27,HOU,60,4,1402,182,432,0.421,83,232,0.358,99,200,0.495,0.517,60,90,0.667,25,117,142,96,42,10,35,112,507
2019,Duncan Robinson\robindu01,SF,25,MIA,65,60,1949,286,613,0.467,243,543,0.448,43,70,0.614,0.665,48,53,0.906,9,203,212,91,35,15,60,179,863
2019,Glenn Robinson III\robingl02,SF,26,TOT,60,52,1743,281,578,0.486,74,191,0.387,207,387,0.535,0.55,72,83,0.867,78,182,260,96,53,16,53,97,708
2019,Glenn Robinson III\robingl02,SF,26,GSW,48,48,1516,244,507,0.481,68,170,0.4,176,337,0.522,0.548,63,74,0.851,66,160,226,85,45,14,50,82,619
2019,Glenn Robinson III\robingl02,SF,26,PHI,12,4,227,37,71,0.521,6,21,0.286,31,50,0.62,0.563,9,9,1,12,22,34,11,8,2,3,15,89
2019,Jerome Robinson\robinje01,SG,22,TOT,55,4,748,75,216,0.347,31,104,0.298,44,112,0.393,0.419,20,29,0.69,9,97,106,65,22,14,34,83,201
2019,Jerome Robinson\robinje01,SG,22,LAC,42,1,476,46,136,0.338,19,67,0.284,27,69,0.391,0.408,11,19,0.579,5,55,60,46,13,8,26,55,122
2019,Jerome Robinson\robinje01,SG,22,WAS,13,3,272,29,80,0.363,12,37,0.324,17,43,0.395,0.438,9,10,0.9,4,42,46,19,9,6,8,28,79
2019,Justin Robinson\robinju01,PG,22,WAS,9,0,49,5,12,0.417,3,5,0.6,2,7,0.286,0.542,0,0,,1,4,5,7,0,1,3,2,13
2019,Mitchell Robinson\robinmi01,C,21,NYK,61,7,1412,253,341,0.742,0,0,,253,341,0.742,0.742,84,148,0.568,186,242,428,36,52,119,37,194,590
2019,Isaiah Roby\robyis01,SF,21,OKC,3,0,11,0,1,0,0,0,,0,1,0,0,0,0,,0,2,2,0,0,0,1,1,0
2019,Rajon Rondo\rondora01,PG,33,LAL,48,3,984,137,328,0.418,41,125,0.328,96,203,0.473,0.48,27,41,0.659,23,119,142,240,40,2,91,58,342
2019,Derrick Rose\rosede01,PG,31,DET,50,15,1298,369,753,0.49,45,147,0.306,324,606,0.535,0.52,121,139,0.871,27,94,121,278,40,16,126,49,904
2019,Terrence Ross\rosste01,SG,28,ORL,63,0,1723,316,777,0.407,162,454,0.357,154,323,0.477,0.511,136,161,0.845,13,190,203,74,69,22,62,95,930
2019,Terry Rozier\roziete01,PG,25,CHO,63,63,2164,398,941,0.423,172,423,0.407,226,518,0.436,0.514,166,190,0.874,50,226,276,259,61,10,141,126,1134
2019,Ricky Rubio\rubiori01,PG,29,PHO,57,57,1802,252,611,0.412,66,188,0.351,186,423,0.44,0.466,174,204,0.853,42,223,265,507,88,9,155,143,744
2019,D'Angelo Russell\russeda01,PG,23,TOT,45,45,1452,360,846,0.426,158,431,0.367,202,415,0.487,0.519,161,199,0.809,17,160,177,285,48,13,147,86,1039
2019,D'Angelo Russell\russeda01,PG,23,GSW,33,33,1060,273,635,0.43,120,321,0.374,153,314,0.487,0.524,113,144,0.785,14,108,122,206,31,9,101,64,779
2019,D'Angelo Russell\russeda01,PG,23,MIN,12,12,392,87,211,0.412,38,110,0.345,49,101,0.485,0.502,48,55,0.873,3,52,55,79,17,4,46,22,260
2019,Domantas Sabonis\sabondo01,C,23,IND,62,62,2159,458,848,0.54,17,67,0.254,441,781,0.565,0.55,214,296,0.723,189,582,771,310,47,30,170,195,1147
2019,Luka Šamanić\samanlu01,PF,20,SAS,1,0,12,0,4,0,0,2,0,0,2,0,0,0,0,,0,2,2,3,0,0,0,0,0
2019,JaKarr Sampson\sampsja02,SF,26,IND,26,10,340,48,81,0.593,2,13,0.154,46,68,0.676,0.605,11,20,0.55,15,44,59,9,9,9,7,43,109
2019,Dario Šarić\saricda01,PF,25,PHO,58,50,1441,217,470,0.462,73,214,0.341,144,256,0.563,0.539,79,95,0.832,89,256,345,109,34,15,72,132,586
2019,Tomáš Satoranský\satorto01,PG,28,CHI,65,64,1878,237,551,0.43,64,199,0.322,173,352,0.491,0.488,106,121,0.876,76,178,254,354,80,7,130,135,644
2019,Admiral Schofield\schofad01,SF,22,WAS,27,2,293,30,75,0.4,14,47,0.298,16,28,0.571,0.493,9,13,0.692,6,28,34,14,8,3,7,41,83
2019,Dennis Schröder\schrode01,PG,26,OKC,63,1,1952,442,945,0.468,122,320,0.381,320,625,0.512,0.532,193,230,0.839,19,214,233,256,43,14,159,138,1199
2019,Mike Scott\scottmi01,PF,31,PHI,63,10,1119,130,319,0.408,73,204,0.358,57,115,0.496,0.522,25,30,0.833,58,167,225,48,19,5,24,85,358
2019,Thabo Sefolosha\sefolth01,PF,35,HOU,41,0,436,37,91,0.407,15,54,0.278,22,37,0.595,0.489,3,8,0.375,21,72,93,25,24,12,15,43,92
2019,Collin Sexton\sextoco01,SG,21,CLE,65,65,2143,513,1086,0.472,97,255,0.38,416,831,0.501,0.517,226,267,0.846,61,143,204,192,65,7,158,142,1349
2019,Landry Shamet\shamela01,SG,22,LAC,47,27,1294,146,351,0.416,105,268,0.392,41,83,0.494,0.566,57,63,0.905,6,84,90,87,19,9,36,130,454
2019,Marial Shayok\shayoma01,SG,24,PHI,2,0,10,1,5,0.2,1,3,0.333,0,2,0,0.3,0,0,,0,3,3,1,0,0,1,0,3
2019,Iman Shumpert\shumpim01,SG,29,BRK,13,0,241,21,64,0.328,8,33,0.242,13,31,0.419,0.391,4,7,0.571,9,25,34,12,12,2,10,21,54
2019,Pascal Siakam\siakapa01,PF,25,TOR,53,53,1882,459,1000,0.459,115,320,0.359,344,680,0.506,0.517,220,275,0.8,57,342,399,191,53,49,132,151,1253
2019,Chris Silva\silvach01,PF,23,MIA,41,0,307,43,69,0.623,0,2,0,43,67,0.642,0.623,34,49,0.694,54,55,109,21,9,18,31,80,120
2019,Ben Simmons\simmobe01,PG,23,PHI,54,54,1930,361,617,0.585,2,6,0.333,359,611,0.588,0.587,178,284,0.627,108,315,423,442,115,32,192,173,902
2019,Anfernee Simons\simonan01,SG,20,POR,65,4,1400,211,525,0.402,74,219,0.338,137,306,0.448,0.472,76,92,0.826,25,122,147,95,26,10,61,131,572
2019,Alen Smailagić\smailal01,PF,19,GSW,14,0,139,20,40,0.5,3,13,0.231,17,27,0.63,0.538,16,19,0.842,10,17,27,13,3,4,11,14,59
2019,Marcus Smart\smartma01,SG,25,BOS,53,39,1721,240,632,0.38,128,368,0.348,112,264,0.424,0.481,106,127,0.835,40,164,204,257,86,27,89,142,714
2019,Dennis Smith Jr.\smithde03,PG,22,NYK,34,3,537,72,211,0.341,16,54,0.296,56,157,0.357,0.379,27,53,0.509,21,57,78,98,28,8,58,65,187
2019,Ish Smith\smithis01,PG,31,WAS,60,19,1570,262,581,0.451,55,150,0.367,207,431,0.48,0.498,48,70,0.686,28,161,189,285,52,24,77,84,627
2019,Zhaire Smith\smithzh01,SG,20,PHI,7,0,32,3,11,0.273,0,3,0,3,8,0.375,0.273,2,4,0.5,0,2,2,2,3,0,2,4,8
2019,Tony Snell\snellto01,SF,28,DET,59,57,1641,170,382,0.445,102,254,0.402,68,128,0.531,0.579,32,32,1,9,102,111,127,32,15,31,101,474
2019,Omari Spellman\spellom01,PF,22,GSW,49,3,886,127,295,0.431,43,110,0.391,84,185,0.454,0.503,73,92,0.793,77,142,219,47,33,24,54,63,370
2019,Max Strus\strusma01,SG,23,CHI,2,0,6,2,3,0.667,0,1,0,2,2,1,0.667,1,1,1,1,0,1,0,0,0,0,1,5
2019,Edmond Sumner\sumneed01,PG,24,IND,25,2,345,47,111,0.423,10,38,0.263,37,73,0.507,0.468,10,15,0.667,10,27,37,39,15,8,19,35,114
2019,Caleb Swanigan\swanica01,PF,22,TOT,27,1,288,28,47,0.596,0,2,0,28,45,0.622,0.596,9,17,0.529,27,73,100,31,3,7,37,62,65
2019,Caleb Swanigan\swanica01,PF,22,SAC,7,0,23,2,4,0.5,0,0,,2,4,0.5,0.5,1,2,0.5,2,5,7,2,1,2,6,8,5
2019,Caleb Swanigan\swanica01,PF,22,POR,20,1,265,26,43,0.605,0,2,0,26,41,0.634,0.605,8,15,0.533,25,68,93,29,2,5,31,54,60
2019,Jayson Tatum\tatumja01,PF,21,BOS,59,59,2043,499,1113,0.448,167,420,0.398,332,693,0.479,0.523,225,279,0.806,57,361,418,174,83,53,132,121,1390
2019,Jeff Teague\teaguje01,PG,31,TOT,59,17,1464,213,489,0.436,43,117,0.368,170,372,0.457,0.48,172,197,0.873,27,115,142,308,44,19,116,106,641
2019,Jeff Teague\teaguje01,PG,31,MIN,34,13,945,145,324,0.448,33,87,0.379,112,237,0.473,0.498,125,144,0.868,15,73,88,208,25,13,76,70,448
2019,Jeff Teague\teaguje01,PG,31,ATL,25,4,519,68,165,0.412,10,30,0.333,58,135,0.43,0.442,47,53,0.887,12,42,54,100,19,6,40,36,193
2019,Garrett Temple\templga01,SG,33,BRK,55,31,1547,198,524,0.378,112,346,0.324,86,178,0.483,0.485,56,73,0.767,28,162,190,141,44,26,57,95,564
2019,Daniel Theis\theisda01,C,27,BOS,58,57,1382,216,382,0.565,26,81,0.321,190,301,0.631,0.599,81,106,0.764,130,250,380,95,35,75,48,201,539
2019,Isaiah Thomas\thomais02,PG,30,WAS,40,37,925,174,426,0.408,78,189,0.413,96,237,0.405,0.5,62,76,0.816,11,57,68,146,13,6,77,77,488
2019,Khyri Thomas\thomakh01,SG,23,DET,8,0,61,5,17,0.294,5,14,0.357,0,3,0,0.441,2,4,0.5,1,0,1,3,3,0,3,9,17
2019,Matt Thomas\thomama02,SG,25,TOR,33,0,321,54,111,0.486,35,75,0.467,19,36,0.528,0.644,7,10,0.7,7,41,48,17,8,0,12,31,150
2019,Tristan Thompson\thomptr01,C,28,CLE,57,51,1721,288,562,0.512,9,23,0.391,279,539,0.518,0.52,99,161,0.615,226,351,577,120,33,50,103,124,684
2019,Matisse Thybulle\thybuma01,SG,22,PHI,57,13,1110,96,234,0.41,50,142,0.352,46,92,0.5,0.517,25,41,0.61,35,51,86,70,80,40,45,120,267
2019,Anthony Tolliver\tollian01,PF,34,TOT,47,9,732,54,155,0.348,39,121,0.322,15,34,0.441,0.474,18,25,0.72,30,103,133,33,15,11,30,64,165
2019,Anthony Tolliver\tollian01,PF,34,POR,33,9,554,43,117,0.368,30,89,0.337,13,28,0.464,0.496,13,19,0.684,27,83,110,29,8,9,21,54,129
2019,Anthony Tolliver\tollian01,PF,34,SAC,9,0,82,3,17,0.176,2,15,0.133,1,2,0.5,0.235,1,2,0.5,2,9,11,3,4,1,4,6,9
2019,Anthony Tolliver\tollian01,PF,34,MEM,5,0,96,8,21,0.381,7,17,0.412,1,4,0.25,0.548,4,4,1,1,11,12,1,3,1,5,4,27
2019,Juan Toscano-Anderson\toscaju01,SF,26,GSW,13,6,272,29,63,0.46,8,23,0.348,21,40,0.525,0.524,3,5,0.6,9,43,52,26,13,5,16,30,69
2019,Karl-Anthony Towns\townska01,C,24,MIN,35,35,1187,316,622,0.508,114,277,0.412,202,345,0.586,0.6,180,226,0.796,95,283,378,153,33,42,110,117,926
2019,Gary Trent Jr.\trentga02,SG,21,POR,53,8,1059,149,350,0.426,78,201,0.388,71,149,0.477,0.537,30,36,0.833,20,68,88,50,39,13,19,69,406
2019,Allonzo Trier\trieral01,PG,24,NYK,24,1,291,51,106,0.481,19,53,0.358,32,53,0.604,0.571,34,43,0.791,6,23,29,28,3,4,22,29,155
2019,P.J. Tucker\tuckepj01,PF,34,HOU,64,64,2203,162,374,0.433,95,257,0.37,67,117,0.573,0.56,37,44,0.841,102,339,441,101,70,31,67,209,456
2019,Rayjon Tucker\tuckera01,SG,22,UTA,14,0,78,8,19,0.421,0,6,0,8,13,0.615,0.421,3,5,0.6,2,11,13,2,1,0,3,7,19
2019,Evan Turner\turneev01,PG,31,ATL,19,0,251,25,67,0.373,0,5,0,25,62,0.403,0.373,12,14,0.857,8,30,38,38,9,8,26,20,62
2019,Myles Turner\turnemy01,C,23,IND,55,55,1628,233,517,0.451,77,229,0.336,156,288,0.542,0.525,108,144,0.75,70,290,360,61,42,120,68,138,651
2019,Jarrod Uthoff\uthofja01,SF,26,MEM,4,0,14,1,7,0.143,0,4,0,1,3,0.333,0.143,2,2,1,1,0,1,0,1,0,0,1,4
2019,Jonas Valančiūnas\valanjo01,C,27,MEM,62,62,1630,385,657,0.586,29,79,0.367,356,578,0.616,0.608,123,168,0.732,190,506,696,109,25,69,107,159,922
2019,Denzel Valentine\valende01,SF,26,CHI,36,5,488,97,237,0.409,46,137,0.336,51,100,0.51,0.506,6,8,0.75,9,65,74,43,26,6,26,51,246
2019,Jarred Vanderbilt\vandeja01,SF-PF,20,TOT,11,0,46,5,8,0.625,0,1,0,5,7,0.714,0.625,2,2,1,3,6,9,2,3,1,7,6,12
2019,Jarred Vanderbilt\vandeja01,SF,20,DEN,9,0,41,5,7,0.714,0,0,,5,7,0.714,0.714,0,0,,3,5,8,2,3,1,7,6,10
2019,Jarred Vanderbilt\vandeja01,PF,20,MIN,2,0,5,0,1,0,0,1,0,0,0,,0,2,2,1,0,1,1,0,0,0,0,0,2
2019,Fred VanVleet\vanvlfr01,PG,25,TOR,48,48,1719,287,701,0.409,131,338,0.388,156,363,0.43,0.503,140,166,0.843,18,162,180,317,91,13,110,118,845
2019,Gabe Vincent\vincega01,PG,23,MIA,6,0,42,4,19,0.211,4,16,0.25,0,3,0,0.316,0,0,,0,3,3,3,1,0,0,2,12
2019,Noah Vonleh\vonleno01,C-PF,24,TOT,33,1,364,50,89,0.562,3,15,0.2,47,74,0.635,0.579,24,30,0.8,37,86,123,27,11,6,21,38,127
2019,Noah Vonleh\vonleno01,C,24,MIN,29,1,347,47,86,0.547,2,14,0.143,45,72,0.625,0.558,23,28,0.821,34,82,116,26,11,6,19,36,119
2019,Noah Vonleh\vonleno01,PF,24,DEN,4,0,17,3,3,1,1,1,1,2,2,1,1.167,1,2,0.5,3,4,7,1,0,0,2,2,8
2019,Nikola Vučević\vucevni01,C,29,ORL,54,54,1763,428,910,0.47,82,249,0.329,346,661,0.523,0.515,114,146,0.781,130,466,596,202,46,47,77,121,1052
2019,Dean Wade\wadede01,PF,23,CLE,12,0,71,9,13,0.692,2,4,0.5,7,9,0.778,0.769,0,1,0,3,16,19,2,2,4,3,8,20
2019,Moritz Wagner\wagnemo01,C,22,WAS,37,5,707,131,228,0.575,23,67,0.343,108,161,0.671,0.625,67,82,0.817,51,141,192,49,22,17,55,134,352
2019,Dion Waiters\waitedi01,SG,28,MIA,3,0,42,10,26,0.385,8,17,0.471,2,9,0.222,0.538,0,1,0,0,11,11,3,0,2,3,5,28
2019,Kemba Walker\walkeke02,PG,29,BOS,50,50,1592,350,832,0.421,165,438,0.377,185,394,0.47,0.52,195,225,0.867,33,171,204,247,47,25,107,77,1060
2019,Lonnie Walker\walkelo01,SG,21,SAS,53,4,767,116,267,0.434,29,71,0.408,87,196,0.444,0.489,38,53,0.717,20,95,115,46,28,13,31,70,299
2019,Tyrone Wallace\wallaty01,SG,25,ATL,14,0,160,14,44,0.318,1,15,0.067,13,29,0.448,0.33,11,17,0.647,3,19,22,13,7,1,10,19,40
2019,Taurean Prince\princta02,SF,25,BRK,64,61,1857,278,739,0.376,146,431,0.339,132,308,0.429,0.475,71,89,0.798,50,331,381,116,57,25,127,159,773
2019,Derrick Walton\waltode01,PG,24,TOT,26,1,248,18,39,0.462,10,24,0.417,8,15,0.533,0.59,7,9,0.778,2,14,16,27,7,0,5,21,53
2019,Derrick Walton\waltode01,PG,24,LAC,23,1,222,17,36,0.472,9,21,0.429,8,15,0.533,0.597,7,9,0.778,2,13,15,22,4,0,4,19,50
2019,Derrick Walton\waltode01,PG,24,DET,3,0,26,1,3,0.333,1,3,0.333,0,0,,0.5,0,0,,0,1,1,5,3,0,1,2,3
2019,Brad Wanamaker\wanambr01,PG,30,BOS,63,1,1215,136,318,0.428,33,90,0.367,103,228,0.452,0.48,108,116,0.931,19,105,124,158,52,12,70,120,413
2019,T.J. Warren\warretj01,SF,26,IND,61,61,1984,460,869,0.529,69,184,0.375,391,685,0.571,0.569,151,186,0.812,61,181,242,87,70,27,77,170,1140
2019,P.J. Washington\washipj01,PF,21,CHO,58,57,1759,268,589,0.455,86,230,0.374,182,359,0.507,0.528,88,136,0.647,58,258,316,123,51,44,93,158,710
2019,Yuta Watanabe\watanyu01,SG,25,MEM,16,0,99,12,29,0.414,3,8,0.375,9,21,0.429,0.466,3,8,0.375,6,11,17,4,5,1,2,9,30
2019,Tremont Waters\watertr01,PG,22,BOS,10,0,89,12,35,0.343,3,17,0.176,9,18,0.5,0.386,6,6,1,0,9,9,12,5,2,10,11,33
2019,Paul Watson\watsopa01,SF-SG,25,TOT,5,0,25,0,8,0,0,4,0,0,4,0,0,1,2,0.5,0,4,4,5,1,1,0,1,1
2019,Paul Watson\watsopa01,SG,25,ATL,2,0,17,0,7,0,0,3,0,0,4,0,0,0,0,,0,2,2,3,1,0,0,1,0
2019,Paul Watson\watsopa01,SF,25,TOR,3,0,8,0,1,0,0,1,0,0,0,,0,1,2,0.5,0,2,2,2,0,1,0,0,1
2019,Quinndary Weatherspoon\weathqu01,SG,23,SAS,3,0,15,0,3,0,0,1,0,0,2,0,0,0,0,,0,1,1,1,0,0,0,0,0
2019,Russell Westbrook\westbru01,PG,31,HOU,53,53,1905,568,1199,0.474,51,201,0.254,517,998,0.518,0.495,269,346,0.777,94,332,426,370,88,17,236,187,1456
2019,Coby White\whiteco01,SG,19,CHI,65,1,1674,312,792,0.394,133,376,0.354,179,416,0.43,0.478,102,129,0.791,28,202,230,175,49,6,109,117,859
2019,Derrick White\whitede01,SG,25,SAS,61,13,1468,213,464,0.459,57,160,0.356,156,304,0.513,0.52,150,175,0.857,30,163,193,206,39,55,75,133,633
2019,Hassan Whiteside\whiteha01,C,30,POR,61,61,1911,418,676,0.618,4,7,0.571,414,669,0.619,0.621,153,225,0.68,244,625,869,74,24,187,117,179,993
2019,Andrew Wiggins\wiggian01,SF-SG,24,TOT,54,54,1858,437,978,0.447,111,334,0.332,326,644,0.506,0.504,190,268,0.709,66,208,274,198,45,53,132,127,1175
2019,Andrew Wiggins\wiggian01,SF,24,MIN,42,42,1455,351,790,0.444,91,275,0.331,260,515,0.505,0.502,149,207,0.72,48,171,219,155,29,36,107,101,942
2019,Andrew Wiggins\wiggian01,SG,24,GSW,12,12,403,86,188,0.457,20,59,0.339,66,129,0.512,0.511,41,61,0.672,18,37,55,43,16,17,25,26,233
2019,Grant Williams\willigr01,PF,21,BOS,62,5,970,80,192,0.417,21,85,0.247,59,107,0.551,0.471,37,51,0.725,58,107,165,62,28,33,46,149,218
2019,Johnathan Williams\willijo04,C,24,WAS,11,5,135,16,25,0.64,0,2,0,16,23,0.696,0.64,3,5,0.6,15,28,43,6,1,6,4,11,35
2019,Kenrich Williams\willike04,PF,25,NOP,35,18,779,49,143,0.343,25,96,0.26,24,47,0.511,0.43,9,24,0.375,49,129,178,53,25,21,21,81,132
2019,Lou Williams\willilo02,SG,33,LAC,60,8,1757,367,883,0.416,107,295,0.363,260,588,0.442,0.476,278,322,0.863,28,158,186,344,40,10,172,77,1119
2019,Marvin Williams\willima02,PF,33,TOT,52,1,1011,110,249,0.442,52,144,0.361,58,105,0.552,0.546,47,54,0.87,20,128,148,56,35,26,28,94,319
2019,Marvin Williams\willima02,PF,33,CHO,41,1,808,94,210,0.448,44,117,0.376,50,93,0.538,0.552,43,50,0.86,15,94,109,41,26,22,25,71,275
2019,Marvin Williams\willima02,PF,33,MIL,11,0,203,16,39,0.41,8,27,0.296,8,12,0.667,0.513,4,4,1,5,34,39,15,9,4,3,23,44
2019,Robert Williams\williro04,C,22,BOS,23,1,323,42,62,0.677,0,0,,42,62,0.677,0.677,14,25,0.56,34,74,108,22,20,28,20,40,98
2019,Nigel Williams-Goss\willini01,PG,25,UTA,9,0,28,1,7,0.143,0,2,0,1,5,0.2,0.143,2,2,1,2,3,5,5,1,1,2,2,4
2019,Zion Williamson\willizi01,PF,19,NOP,19,19,565,172,292,0.589,6,13,0.462,166,279,0.595,0.599,98,152,0.645,55,74,129,41,16,9,51,32,448
2019,D.J. Wilson\wilsodj01,PF,23,MIL,31,0,280,40,101,0.396,14,55,0.255,26,46,0.565,0.465,6,9,0.667,10,58,68,22,2,5,15,26,100
2019,Justise Winslow\winslju01,SF,23,MIA,11,5,352,50,129,0.388,6,27,0.222,44,102,0.431,0.411,18,27,0.667,16,57,73,44,7,5,24,38,124
2019,Christian Wood\woodch01,PF,24,DET,62,12,1325,288,508,0.567,54,140,0.386,234,368,0.636,0.62,180,242,0.744,104,286,390,60,34,54,84,98,810
2019,Delon Wright\wrighde01,SG,27,DAL,65,5,1412,179,381,0.47,45,117,0.385,134,264,0.508,0.529,71,90,0.789,66,193,259,220,76,21,68,83,474
2019,Justin Wright-Foreman\wrighju02,PG,22,UTA,1,0,2,0,0,,0,0,,0,0,,,0,0,,0,0,0,0,0,0,0,0,0
2019,Thaddeus Young\youngth01,PF,31,CHI,64,16,1591,269,601,0.448,79,222,0.356,190,379,0.501,0.513,42,72,0.583,94,221,315,117,92,23,102,134,659
2019,Trae Young\youngtr01,PG,21,ATL,60,60,2120,546,1249,0.437,205,568,0.361,341,681,0.501,0.519,481,559,0.86,32,223,255,560,65,8,289,104,1778
2019,Cody Zeller\zelleco01,C,27,CHO,58,39,1341,251,479,0.524,18,75,0.24,233,404,0.577,0.543,122,179,0.682,160,251,411,88,40,25,75,140,642
2019,Ante Žižić\zizican01,C,23,CLE,22,0,221,41,72,0.569,0,0,,41,72,0.569,0.569,14,19,0.737,18,48,66,6,7,5,10,27,96
2019,Ivica Zubac\zubaciv01,C,22,LAC,64,62,1156,202,336,0.601,0,2,0,202,334,0.605,0.601,107,141,0.759,166,295,461,69,13,60,53,146,511
2018,Álex Abrines\abrinal01,SG,25,OKC,31,2,588,56,157,0.357,41,127,0.323,15,30,0.5,0.487,12,13,0.923,5,43,48,20,17,6,14,53,165
2018,Quincy Acy\acyqu01,PF,28,PHO,10,0,123,4,18,0.222,2,15,0.133,2,3,0.667,0.278,7,10,0.7,3,22,25,8,1,4,4,24,17
2018,Jaylen Adams\adamsja01,PG,22,ATL,34,1,428,38,110,0.345,25,74,0.338,13,36,0.361,0.459,7,9,0.778,11,49,60,65,14,5,28,45,108
2018,Steven Adams\adamsst01,C,25,OKC,80,80,2669,481,809,0.595,0,2,0,481,807,0.596,0.595,146,292,0.5,391,369,760,124,117,76,135,204,1108
2018,Bam Adebayo\adebaba01,C,21,MIA,82,28,1913,280,486,0.576,3,15,0.2,277,471,0.588,0.579,166,226,0.735,165,432,597,184,71,65,121,203,729
2018,Deng Adel\adelde01,SF,21,CLE,19,3,194,11,36,0.306,6,23,0.261,5,13,0.385,0.389,4,4,1,3,16,19,5,1,4,6,13,32
2018,DeVaughn Akoon-Purcell\akoonde01,SG,25,DEN,7,0,22,3,10,0.3,0,4,0,3,6,0.5,0.3,1,2,0.5,1,3,4,6,2,0,2,4,7
2018,LaMarcus Aldridge\aldrila01,C,33,SAS,81,81,2687,684,1319,0.519,10,42,0.238,674,1277,0.528,0.522,349,412,0.847,251,493,744,194,43,107,144,179,1727
2018,Rawle Alkins\alkinra01,SG,21,CHI,10,1,120,13,39,0.333,3,12,0.25,10,27,0.37,0.372,8,12,0.667,11,15,26,13,1,0,8,7,37
2018,Grayson Allen\allengr01,SG,23,UTA,38,2,416,67,178,0.376,32,99,0.323,35,79,0.443,0.466,45,60,0.75,3,20,23,25,6,6,33,47,211
2018,Jarrett Allen\allenja01,C,20,BRK,80,80,2096,335,568,0.59,6,45,0.133,329,523,0.629,0.595,197,278,0.709,191,481,672,110,43,120,103,184,873
2018,Kadeem Allen\allenka01,SG,26,NYK,19,1,416,65,141,0.461,17,36,0.472,48,105,0.457,0.521,42,54,0.778,8,43,51,76,16,4,26,46,189
2018,Al-Farouq Aminu\aminual01,PF,28,POR,81,81,2292,257,593,0.433,96,280,0.343,161,313,0.514,0.514,150,173,0.867,112,498,610,104,68,33,72,143,760
2018,Justin Anderson\anderju01,SF,25,ATL,48,4,463,64,157,0.408,24,77,0.312,40,80,0.5,0.484,26,35,0.743,24,60,84,23,22,13,23,48,178
2018,Kyle Anderson\anderky01,SF,25,MEM,43,40,1281,150,276,0.543,9,34,0.265,141,242,0.583,0.56,37,64,0.578,48,203,251,128,54,37,58,112,346
2018,Ryan Anderson\anderry01,PF,30,TOT,25,8,322,21,69,0.304,9,40,0.225,12,29,0.414,0.37,12,16,0.75,18,36,54,19,4,1,14,25,63
2018,Ryan Anderson\anderry01,PF,30,PHO,15,8,278,19,60,0.317,7,34,0.206,12,26,0.462,0.375,11,14,0.786,14,31,45,17,3,1,12,23,56
2018,Ryan Anderson\anderry01,PF,30,MIA,10,0,44,2,9,0.222,2,6,0.333,0,3,0,0.333,1,2,0.5,4,5,9,2,1,0,2,2,7
2018,Ike Anigbogu\anigbik01,C,20,IND,3,0,6,0,3,0,0,0,,0,3,0,0,0,0,,1,2,3,1,0,1,1,0,0
2018,Giannis Antetokounmpo\antetgi01,PF,24,MIL,72,72,2358,721,1247,0.578,52,203,0.256,669,1044,0.641,0.599,500,686,0.729,159,739,898,424,92,110,268,232,1994
2018,Kostas Antetokounmpo\antetko01,PF,21,DAL,2,0,11,0,3,0,0,0,,0,3,0,0,2,4,0.5,0,1,1,0,2,0,1,0,2
2018,Carmelo Anthony\anthoca01,PF,34,HOU,10,2,294,49,121,0.405,21,64,0.328,28,57,0.491,0.492,15,22,0.682,9,45,54,5,4,7,8,32,134
2018,OG Anunoby\anunoog01,SF,21,TOR,67,6,1352,183,404,0.453,67,202,0.332,116,202,0.574,0.536,36,62,0.581,58,139,197,47,46,22,55,140,469
2018,Ryan Arcidiacono\arcidry01,PG,24,CHI,81,32,1961,187,418,0.447,81,217,0.373,106,201,0.527,0.544,89,102,0.873,27,192,219,269,65,4,63,171,544
2018,Trevor Ariza\arizatr01,SF,33,TOT,69,69,2349,294,736,0.399,145,434,0.334,149,302,0.493,0.498,130,164,0.793,50,321,371,252,91,21,106,130,863
2018,Trevor Ariza\arizatr01,SF,33,PHO,26,26,884,86,227,0.379,50,139,0.36,36,88,0.409,0.489,36,43,0.837,16,129,145,87,38,8,39,44,258
2018,Trevor Ariza\arizatr01,SF,33,WAS,43,43,1465,208,509,0.409,95,295,0.322,113,214,0.528,0.502,94,121,0.777,34,192,226,165,53,13,67,86,605
2018,D.J. Augustin\augusdj01,PG,31,ORL,81,81,2269,318,677,0.47,131,311,0.421,187,366,0.511,0.566,181,209,0.866,41,162,203,426,52,4,128,115,948
2018,Deandre Ayton\aytonde01,C,20,PHO,71,70,2183,509,870,0.585,0,4,0,509,866,0.588,0.585,141,189,0.746,223,506,729,125,61,67,126,209,1159
2018,Dwayne Bacon\bacondw01,SG,23,CHO,43,13,759,122,257,0.475,38,87,0.437,84,170,0.494,0.549,34,46,0.739,8,81,89,47,12,5,18,72,316
2018,Marvin Bagley\baglema01,PF,19,SAC,62,4,1567,356,706,0.504,30,96,0.313,326,610,0.534,0.525,181,262,0.691,162,309,471,62,33,59,98,120,923
2018,Ron Baker\bakerro01,SG,25,TOT,15,0,152,4,20,0.2,1,13,0.077,3,7,0.429,0.225,5,6,0.833,1,10,11,15,6,1,5,18,14
2018,Ron Baker\bakerro01,SG,25,NYK,11,0,107,4,16,0.25,1,9,0.111,3,7,0.429,0.281,5,6,0.833,1,6,7,13,5,0,3,16,14
2018,Ron Baker\bakerro01,SG,25,WAS,4,0,45,0,4,0,0,4,0,0,0,,0,0,0,,0,4,4,2,1,1,2,2,0
2018,Wade Baldwin\baldwwa01,PG,22,POR,16,0,94,10,33,0.303,2,9,0.222,8,24,0.333,0.333,8,11,0.727,2,13,15,12,1,2,14,11,30
2018,Lonzo Ball\balllo01,PG,21,LAL,47,45,1423,185,456,0.406,75,228,0.329,110,228,0.482,0.488,20,48,0.417,54,197,251,255,69,19,103,114,465
2018,Mo Bamba\bambamo01,C,20,ORL,47,1,766,117,243,0.481,21,70,0.3,96,173,0.555,0.525,37,63,0.587,64,169,233,39,13,64,43,102,292
2018,J.J. Barea\bareajo01,PG,34,DAL,38,0,752,161,385,0.418,38,128,0.297,123,257,0.479,0.468,55,78,0.705,13,82,95,211,22,1,72,50,415
2018,Harrison Barnes\barneha02,PF-SF,26,TOT,77,77,2533,431,1027,0.42,174,441,0.395,257,586,0.439,0.504,229,278,0.824,57,304,361,115,50,13,98,122,1265
2018,Harrison Barnes\barneha02,PF,26,DAL,49,49,1584,290,717,0.404,121,311,0.389,169,406,0.416,0.489,165,198,0.833,36,171,207,62,33,11,68,79,866
2018,Harrison Barnes\barneha02,SF,26,SAC,28,28,949,141,310,0.455,53,130,0.408,88,180,0.489,0.54,64,80,0.8,21,133,154,53,17,2,30,43,399
2018,Will Barton\bartowi01,SF,28,DEN,43,38,1189,185,460,0.402,67,196,0.342,118,264,0.447,0.475,57,74,0.77,32,167,199,124,18,22,65,82,494
2018,Keita Bates-Diop\bateske01,SF,23,MIN,30,3,503,60,142,0.423,13,52,0.25,47,90,0.522,0.468,18,28,0.643,16,67,83,17,18,14,14,29,151
2018,Nicolas Batum\batumni01,SF,30,CHO,75,72,2354,253,562,0.45,116,298,0.389,137,264,0.519,0.553,77,89,0.865,71,319,390,247,71,43,117,140,699
2018,Jerryd Bayless\bayleje01,PG,30,MIN,34,6,657,82,230,0.357,29,98,0.296,53,132,0.402,0.42,16,28,0.571,11,51,62,119,18,2,32,56,209
2018,Aron Baynes\baynear01,C,32,BOS,51,18,821,105,223,0.471,21,61,0.344,84,162,0.519,0.518,53,62,0.855,88,152,240,57,12,34,40,125,284
2018,Kent Bazemore\bazemke01,SG,29,ATL,67,35,1643,278,691,0.402,96,300,0.32,182,391,0.465,0.472,127,175,0.726,37,224,261,152,89,42,121,170,779
2018,Bradley Beal\bealbr01,SG,25,WAS,82,82,3028,764,1609,0.475,209,596,0.351,555,1013,0.548,0.54,362,448,0.808,89,322,411,448,121,58,224,226,2099
2018,Malik Beasley\beaslma01,SG,22,DEN,81,18,1879,349,737,0.474,163,405,0.402,186,332,0.56,0.584,56,66,0.848,35,165,200,97,55,10,55,116,917
2018,Michael Beasley\beaslmi01,PF,30,LAL,26,2,277,75,153,0.49,3,17,0.176,72,136,0.529,0.5,28,39,0.718,13,47,60,25,9,10,27,42,181
2018,Marco Belinelli\belinma01,SG,32,SAS,79,1,1815,285,690,0.413,147,395,0.372,138,295,0.468,0.52,112,124,0.903,16,182,198,132,35,8,72,121,829
2018,Jordan Bell\belljo01,C,24,GSW,68,3,788,99,192,0.516,0,2,0,99,190,0.521,0.516,25,41,0.61,55,129,184,76,20,51,42,80,223
2018,DeAndre' Bembry\bembrde01,SG,24,ATL,82,15,1931,275,616,0.446,50,173,0.289,225,443,0.508,0.487,87,136,0.64,54,304,358,202,105,41,142,190,687
2018,Dragan Bender\bendedr01,PF,21,PHO,46,27,826,88,197,0.447,22,101,0.218,66,96,0.688,0.503,32,54,0.593,34,149,183,56,18,22,37,90,230
2018,Dairis Bertāns\bertada02,SG,29,NOP,12,0,167,12,47,0.255,10,34,0.294,2,13,0.154,0.362,0,0,,2,7,9,10,1,0,2,7,34
2018,Dāvis Bertāns\bertada01,PF,26,SAS,76,12,1632,204,453,0.45,145,338,0.429,59,115,0.513,0.61,53,60,0.883,23,241,264,100,35,33,43,133,606
2018,Patrick Beverley\beverpa01,PG,30,LAC,78,49,2137,194,477,0.407,112,282,0.397,82,195,0.421,0.524,96,123,0.78,76,312,388,300,67,43,85,265,596
2018,Khem Birch\birchkh01,C,26,ORL,50,1,643,91,151,0.603,0,1,0,91,150,0.607,0.603,58,83,0.699,79,111,190,38,18,29,20,72,240
2018,Bismack Biyombo\biyombi01,C,26,CHO,54,32,783,89,156,0.571,0,0,,89,156,0.571,0.571,58,91,0.637,81,166,247,33,11,41,34,103,236
2018,Nemanja Bjelica\bjeline01,PF,30,SAC,77,70,1788,284,593,0.479,103,257,0.401,181,336,0.539,0.566,70,92,0.761,125,319,444,147,54,56,82,197,741
2018,Antonio Blakeney\blakean01,SG,22,CHI,57,3,829,166,396,0.419,36,91,0.396,130,305,0.426,0.465,50,76,0.658,7,99,106,42,12,9,35,41,418
2018,Eric Bledsoe\bledser01,PG,29,MIL,78,78,2272,470,971,0.484,124,377,0.329,346,594,0.582,0.548,177,236,0.75,82,280,362,430,116,29,165,156,1241
2018,Jaron Blossomgame\blossja01,SF,25,CLE,27,4,439,47,106,0.443,10,39,0.256,37,67,0.552,0.491,10,13,0.769,26,72,98,13,7,8,11,20,114
2018,Bogdan Bogdanović\bogdabo01,SG,26,SAC,70,17,1947,361,863,0.418,134,372,0.36,227,491,0.462,0.496,134,162,0.827,40,203,243,267,72,15,117,142,990
2018,Bojan Bogdanović\bogdabo02,SF,29,IND,81,81,2573,522,1051,0.497,164,386,0.425,358,665,0.538,0.575,246,305,0.807,33,300,333,161,69,1,134,138,1454
2018,Andrew Bogut\bogutan01,C,34,GSW,11,5,134,18,36,0.5,0,0,,18,36,0.5,0.5,3,3,1,12,43,55,11,3,8,8,22,39
2018,Jonah Bolden\boldejo01,PF,23,PHI,44,10,639,80,162,0.494,34,96,0.354,46,66,0.697,0.599,13,27,0.481,47,118,165,40,17,39,36,99,207
2018,Isaac Bonga\bongais01,PG,19,LAL,22,0,120,5,33,0.152,0,8,0,5,25,0.2,0.152,9,15,0.6,9,16,25,15,9,4,6,9,19
2018,Devin Booker\bookede01,SG,22,PHO,64,64,2242,586,1255,0.467,135,414,0.326,451,841,0.536,0.521,393,454,0.866,39,226,265,433,56,13,264,200,1700
2018,Chris Boucher\bouchch01,PF,26,TOR,28,0,163,34,76,0.447,12,37,0.324,22,39,0.564,0.526,13,15,0.867,16,40,56,2,6,24,7,31,93
2018,Avery Bradley\bradlav01,SG,28,TOT,63,63,1905,248,608,0.408,86,245,0.351,162,363,0.446,0.479,43,50,0.86,43,132,175,152,41,16,89,167,625
2018,Avery Bradley\bradlav01,SG,28,LAC,49,49,1463,161,420,0.383,58,172,0.337,103,248,0.415,0.452,20,25,0.8,35,96,131,96,27,16,61,133,400
2018,Avery Bradley\bradlav01,SG,28,MEM,14,14,442,87,188,0.463,28,73,0.384,59,115,0.513,0.537,23,25,0.92,8,36,44,56,14,0,28,34,225
2018,Tony Bradley\bradlto01,C,21,UTA,3,0,36,8,16,0.5,0,0,,8,16,0.5,0.5,1,2,0.5,9,6,15,1,2,2,3,6,17
2018,Corey Brewer\breweco01,SF,32,TOT,31,3,492,53,123,0.431,14,44,0.318,39,79,0.494,0.488,31,43,0.721,26,50,76,39,32,7,19,63,151
2018,Corey Brewer\breweco01,SF,32,PHI,7,3,140,20,49,0.408,4,14,0.286,16,35,0.457,0.449,9,13,0.692,4,13,17,10,12,2,8,16,53
2018,Corey Brewer\breweco01,SF,32,SAC,24,0,352,33,74,0.446,10,30,0.333,23,44,0.523,0.514,22,30,0.733,22,37,59,29,20,5,11,47,98
2018,Mikal Bridges\bridgmi01,SF,22,PHO,82,56,2417,242,563,0.43,105,313,0.335,137,250,0.548,0.523,95,118,0.805,56,208,264,173,129,38,70,201,684
2018,Miles Bridges\bridgmi02,SF,20,CHO,80,25,1696,237,511,0.464,65,200,0.325,172,311,0.553,0.527,58,77,0.753,67,256,323,95,55,49,50,111,597
2018,Isaiah Briscoe\briscis01,PG,22,ORL,39,0,559,55,138,0.399,11,34,0.324,44,104,0.423,0.438,15,26,0.577,5,69,74,87,11,2,31,66,136
2018,Ryan Broekhoff\broekry01,SG,28,DAL,42,0,453,57,126,0.452,38,93,0.409,19,33,0.576,0.603,15,19,0.789,8,55,63,22,6,4,16,35,167
2018,Malcolm Brogdon\brogdma01,SG,26,MIL,64,64,1832,378,748,0.505,104,244,0.426,274,504,0.544,0.575,141,152,0.928,65,223,288,205,46,13,91,102,1001
2018,Dillon Brooks\brookdi01,SF,23,MEM,18,0,330,49,122,0.402,15,40,0.375,34,82,0.415,0.463,22,30,0.733,9,22,31,16,10,4,19,50,135
2018,MarShon Brooks\brookma01,SG,30,MEM,29,0,387,76,169,0.45,15,54,0.278,61,115,0.53,0.494,23,33,0.697,12,33,45,25,9,4,21,33,190
2018,Bruce Brown\brownbr01,SG,22,DET,74,56,1449,125,314,0.398,24,93,0.258,101,221,0.457,0.436,45,60,0.75,48,137,185,91,40,36,46,178,319
2018,Jaylen Brown\brownja02,SG,22,BOS,74,25,1913,368,792,0.465,95,276,0.344,273,516,0.529,0.525,133,202,0.658,65,248,313,100,69,32,99,186,964
2018,Lorenzo Brown\brownlo01,PG,28,TOR,26,0,212,23,71,0.324,6,28,0.214,17,43,0.395,0.366,3,3,1,5,26,31,28,12,5,16,22,55
2018,Sterling Brown\brownst02,SG,23,MIL,58,7,1034,145,312,0.465,53,147,0.361,92,165,0.558,0.55,29,42,0.69,29,155,184,84,25,8,46,88,372
2018,Troy Brown\browntr01,SF,19,WAS,52,10,730,97,234,0.415,22,69,0.319,75,165,0.455,0.462,32,47,0.681,35,110,145,80,21,5,30,56,248
2018,Jalen Brunson\brunsja01,PG,22,DAL,73,38,1591,264,565,0.467,63,181,0.348,201,384,0.523,0.523,87,120,0.725,25,144,169,230,37,4,88,127,678
2018,Thomas Bryant\bryanth01,C,21,WAS,72,53,1496,309,502,0.616,33,99,0.333,276,403,0.685,0.648,107,137,0.781,113,341,454,92,25,67,60,126,758
2018,Reggie Bullock\bullore01,SG,27,TOT,63,60,1879,245,594,0.412,148,393,0.377,97,201,0.483,0.537,73,85,0.859,22,151,173,129,40,12,65,109,711
2018,Reggie Bullock\bullore01,SG,27,DET,44,44,1355,182,441,0.413,114,294,0.388,68,147,0.463,0.542,56,64,0.875,20,103,123,109,24,5,54,79,534
2018,Reggie Bullock\bullore01,SG,27,LAL,19,16,524,63,153,0.412,34,99,0.343,29,54,0.537,0.523,17,21,0.81,2,48,50,20,16,7,11,30,177
2018,Trey Burke\burketr01,PG,26,TOT,58,8,1125,236,548,0.431,56,159,0.352,180,389,0.463,0.482,103,124,0.831,28,71,99,159,33,7,49,58,631
2018,Trey Burke\burketr01,PG,26,NYK,33,7,689,148,358,0.413,30,86,0.349,118,272,0.434,0.455,62,75,0.827,15,47,62,94,21,5,29,33,388
2018,Trey Burke\burketr01,PG,26,DAL,25,1,436,88,190,0.463,26,73,0.356,62,117,0.53,0.532,41,49,0.837,13,24,37,65,12,2,20,25,243
2018,Alec Burks\burksal01,SG,27,TOT,64,24,1375,192,474,0.405,61,168,0.363,131,306,0.428,0.469,116,141,0.823,30,205,235,128,39,21,65,91,561
2018,Alec Burks\burksal01,SG,27,UTA,17,0,269,47,114,0.412,16,43,0.372,31,71,0.437,0.482,33,38,0.868,2,25,27,20,6,4,15,22,143
2018,Alec Burks\burksal01,SG,27,CLE,34,24,979,136,340,0.4,45,119,0.378,91,221,0.412,0.466,79,98,0.806,26,160,186,98,25,16,46,62,396
2018,Alec Burks\burksal01,SG,27,SAC,13,0,127,9,20,0.45,0,6,0,9,14,0.643,0.45,4,5,0.8,2,20,22,10,8,1,4,7,22
2018,Deonte Burton\burtode02,SG,25,OKC,32,0,240,33,82,0.402,8,27,0.296,25,55,0.455,0.451,8,12,0.667,4,24,28,9,6,8,9,31,82
2018,Jimmy Butler\butleji01,SF-SG,29,TOT,65,65,2185,418,904,0.462,67,193,0.347,351,711,0.494,0.499,312,365,0.855,121,221,342,263,123,39,95,111,1215
2018,Jimmy Butler\butleji01,SG,29,MIN,10,10,361,74,157,0.471,17,45,0.378,57,112,0.509,0.525,48,61,0.787,16,36,52,43,24,10,14,18,213
2018,Jimmy Butler\butleji01,SF,29,PHI,55,55,1824,344,747,0.461,50,148,0.338,294,599,0.491,0.494,264,304,0.868,105,185,290,220,99,29,81,93,1002
2018,Bruno Caboclo\cabocbr01,SF,23,MEM,34,19,800,96,225,0.427,48,130,0.369,48,95,0.505,0.533,42,50,0.84,42,116,158,50,14,33,38,81,282
2018,José Calderón\caldejo01,PG,37,DET,49,0,632,45,120,0.375,14,57,0.246,31,63,0.492,0.433,9,11,0.818,11,49,60,115,16,3,35,64,113
2018,Kentavious Caldwell-Pope\caldwke01,SG,25,LAL,82,23,2035,325,756,0.43,151,435,0.347,174,321,0.542,0.53,137,158,0.867,48,190,238,110,73,13,65,137,938
2018,Isaiah Canaan\canaais01,PG,27,TOT,30,16,629,64,164,0.39,34,96,0.354,30,68,0.441,0.494,19,24,0.792,6,52,58,84,14,2,35,52,181
2018,Isaiah Canaan\canaais01,PG,27,PHO,19,15,503,51,129,0.395,25,72,0.347,26,57,0.456,0.492,15,20,0.75,5,44,49,62,12,0,29,46,142
2018,Isaiah Canaan\canaais01,PG,27,MIN,7,1,95,11,29,0.379,7,19,0.368,4,10,0.4,0.5,4,4,1,0,5,5,19,2,1,4,4,33
2018,Isaiah Canaan\canaais01,PG,27,MIL,4,0,31,2,6,0.333,2,5,0.4,0,1,0,0.5,0,0,,1,3,4,3,0,1,2,2,6
2018,Clint Capela\capelca01,C,24,HOU,67,67,2249,474,732,0.648,0,0,,474,732,0.648,0.648,166,261,0.636,298,550,848,96,44,102,94,168,1114
2018,DeMarre Carroll\carrode01,PF,32,BRK,67,8,1703,227,575,0.395,106,310,0.342,121,265,0.457,0.487,184,242,0.76,68,281,349,85,31,10,73,114,744
2018,Jevon Carter\carteje01,PG,23,MEM,39,3,577,56,185,0.303,34,102,0.333,22,83,0.265,0.395,26,32,0.813,14,52,66,69,26,11,33,55,172
2018,Vince Carter\cartevi01,PF,42,ATL,76,9,1330,196,468,0.419,123,316,0.389,73,152,0.48,0.55,47,66,0.712,31,163,194,87,44,27,48,141,562
2018,Wendell Carter\cartewe01,C,19,CHI,44,44,1110,180,371,0.485,6,32,0.188,174,339,0.513,0.493,89,112,0.795,87,220,307,78,26,58,65,152,455
2018,Michael Carter-Williams\cartemi01,PG,27,TOT,28,1,372,46,123,0.374,10,38,0.263,36,85,0.424,0.415,32,53,0.604,19,51,70,70,20,15,20,48,134
2018,Michael Carter-Williams\cartemi01,PG,27,HOU,16,1,145,25,61,0.41,7,19,0.368,18,42,0.429,0.467,12,26,0.462,3,10,13,21,9,6,10,27,69
2018,Michael Carter-Williams\cartemi01,PG,27,ORL,12,0,227,21,62,0.339,3,19,0.158,18,43,0.419,0.363,20,27,0.741,16,41,57,49,11,9,10,21,65
2018,Alex Caruso\carusal01,PG,24,LAL,25,4,531,77,173,0.445,24,50,0.48,53,123,0.431,0.514,51,64,0.797,20,47,67,77,24,9,42,54,229
2018,Omri Casspi\casspom01,SF,30,MEM,36,0,520,86,161,0.534,15,43,0.349,71,118,0.602,0.581,39,58,0.672,17,98,115,26,20,9,23,35,226
2018,Willie Cauley-Stein\caulewi01,C,25,SAC,81,81,2213,412,741,0.556,1,2,0.5,411,739,0.556,0.557,140,254,0.551,181,497,678,194,96,51,84,227,965
2018,Troy Caupain\caupatr01,PG,23,ORL,4,0,16,4,8,0.5,2,3,0.667,2,5,0.4,0.625,0,0,,1,2,3,4,1,0,0,0,10
2018,Tyler Cavanaugh\cavanty01,PF,24,UTA,11,0,39,3,10,0.3,1,5,0.2,2,5,0.4,0.35,2,2,1,3,5,8,1,0,0,1,3,9
2018,Tyson Chandler\chandty01,C,36,TOT,55,6,875,61,99,0.616,0,1,0,61,98,0.622,0.616,51,87,0.586,92,215,307,37,21,23,42,110,173
2018,Tyson Chandler\chandty01,C,36,PHO,7,0,89,8,12,0.667,0,0,,8,12,0.667,0.667,10,18,0.556,7,32,39,6,2,1,7,21,26
2018,Tyson Chandler\chandty01,C,36,LAL,48,6,786,53,87,0.609,0,1,0,53,86,0.616,0.609,41,69,0.594,85,183,268,31,19,22,35,89,147
2018,Wilson Chandler\chandwi01,PF-SF,31,TOT,51,33,1177,114,273,0.418,59,158,0.373,55,115,0.478,0.526,18,25,0.72,48,167,215,82,25,21,46,123,305
2018,Wilson Chandler\chandwi01,PF,31,PHI,36,32,951,91,207,0.44,46,118,0.39,45,89,0.506,0.551,13,18,0.722,44,124,168,72,22,18,39,94,241
2018,Wilson Chandler\chandwi01,SF,31,LAC,15,1,226,23,66,0.348,13,40,0.325,10,26,0.385,0.447,5,7,0.714,4,43,47,10,3,3,7,29,64
2018,Joe Chealey\chealjo01,PG,23,CHO,1,0,8,1,3,0.333,0,0,,1,3,0.333,0.333,0,0,,0,0,0,1,0,0,0,1,2
2018,Chris Chiozza\chiozch01,PG,23,HOU,7,0,33,2,8,0.25,2,5,0.4,0,3,0,0.375,0,0,,1,3,4,4,1,1,1,2,6
2018,Marquese Chriss\chrisma01,PF,21,TOT,43,2,499,67,180,0.372,16,72,0.222,51,108,0.472,0.417,32,45,0.711,40,102,142,22,17,11,36,81,182
2018,Marquese Chriss\chrisma01,PF,21,HOU,16,0,104,11,34,0.324,1,15,0.067,10,19,0.526,0.338,6,7,0.857,7,21,28,6,2,4,12,17,29
2018,Marquese Chriss\chrisma01,PF,21,CLE,27,2,395,56,146,0.384,15,57,0.263,41,89,0.461,0.435,26,38,0.684,33,81,114,16,15,7,24,64,153
2018,Gary Clark\clarkga01,PF,24,HOU,51,2,641,50,151,0.331,41,138,0.297,9,13,0.692,0.467,7,7,1,24,92,116,18,20,26,7,47,148
2018,Ian Clark\clarkia01,SG,27,NOP,60,6,973,151,383,0.394,66,202,0.327,85,181,0.47,0.48,33,37,0.892,13,76,89,94,22,8,58,95,401
2018,Jordan Clarkson\clarkjo01,SG,26,CLE,81,0,2214,529,1180,0.448,144,445,0.324,385,735,0.524,0.509,162,192,0.844,82,188,270,196,57,13,135,112,1364
2018,John Collins\collijo01,PF,21,ATL,61,59,1829,465,831,0.56,55,158,0.348,410,673,0.609,0.593,203,266,0.763,219,376,595,121,22,39,120,199,1188
2018,Zach Collins\colliza01,C,21,POR,77,0,1356,189,400,0.473,40,121,0.331,149,279,0.534,0.523,94,126,0.746,109,215,324,71,25,66,77,174,512
2018,Darren Collison\collida01,PG,31,IND,76,76,2143,308,659,0.467,79,194,0.407,229,465,0.492,0.527,158,190,0.832,36,196,232,459,110,9,125,138,853
2018,Bonzie Colson\colsobo01,SF,23,MIL,8,2,98,13,39,0.333,5,21,0.238,8,18,0.444,0.397,8,9,0.889,8,22,30,3,5,1,3,3,39
2018,Mike Conley\conlemi01,PG,31,MEM,70,70,2342,490,1120,0.438,155,426,0.364,335,694,0.483,0.507,343,406,0.845,40,199,239,449,94,22,130,123,1478
2018,Pat Connaughton\connapa01,SG,26,MIL,61,2,1261,163,350,0.466,66,200,0.33,97,150,0.647,0.56,29,40,0.725,61,197,258,122,33,25,33,81,421
2018,Quinn Cook\cookqu01,PG,25,GSW,74,10,1059,204,439,0.465,81,200,0.405,123,239,0.515,0.557,20,26,0.769,22,135,157,116,20,3,50,92,509
2018,DeMarcus Cousins\couside01,C,28,GSW,30,30,771,178,371,0.48,26,95,0.274,152,276,0.551,0.515,106,144,0.736,43,204,247,107,40,44,72,109,488
2018,Robert Covington\covinro01,SF,28,TOT,35,35,1203,156,362,0.431,85,225,0.378,71,137,0.518,0.548,68,89,0.764,28,165,193,46,74,47,47,126,465
2018,Robert Covington\covinro01,SF,28,PHI,13,13,440,50,117,0.427,30,77,0.39,20,40,0.5,0.556,17,23,0.739,7,60,67,14,24,23,22,45,147
2018,Robert Covington\covinro01,SF,28,MIN,22,22,763,106,245,0.433,55,148,0.372,51,97,0.526,0.545,51,66,0.773,21,105,126,32,50,24,25,81,318
2018,Allen Crabbe\crabbal01,SG,26,BRK,43,20,1133,137,373,0.367,98,259,0.378,39,114,0.342,0.499,41,56,0.732,16,132,148,46,23,13,46,102,413
2018,Torrey Craig\craigto01,SF,28,DEN,75,37,1503,160,362,0.442,61,188,0.324,99,174,0.569,0.526,49,70,0.7,89,174,263,72,37,46,44,175,430
2018,Jamal Crawford\crawfja01,SG,38,PHO,64,0,1211,174,438,0.397,67,202,0.332,107,236,0.453,0.474,93,110,0.845,8,77,85,229,33,12,99,75,508
2018,Mitch Creek\creekmi01,SF,26,TOT,5,0,48,8,16,0.5,0,2,0,8,14,0.571,0.5,5,7,0.714,6,6,12,6,2,0,1,3,21
2018,Mitch Creek\creekmi01,SF,26,BRK,4,0,36,5,10,0.5,0,1,0,5,9,0.556,0.5,5,7,0.714,5,5,10,5,1,0,0,3,15
2018,Mitch Creek\creekmi01,SF,26,MIN,1,0,12,3,6,0.5,0,1,0,3,5,0.6,0.5,0,0,,1,1,2,1,1,0,1,0,6
2018,Jae Crowder\crowdja01,SF,28,UTA,80,11,2166,318,797,0.399,173,522,0.331,145,275,0.527,0.508,142,197,0.721,60,324,384,133,64,31,85,170,951
2018,Dante Cunningham\cunnida01,PF,31,SAS,64,21,928,75,158,0.475,30,65,0.462,45,93,0.484,0.57,14,18,0.778,48,140,188,50,27,13,22,71,194
2018,Seth Curry\curryse01,SG,28,POR,74,2,1399,212,465,0.456,113,251,0.45,99,214,0.463,0.577,44,52,0.846,27,93,120,66,36,12,61,97,581
2018,Stephen Curry\curryst01,PG,30,GSW,69,69,2331,632,1340,0.472,354,810,0.437,278,530,0.525,0.604,263,287,0.916,45,324,369,361,92,25,192,166,1881
2018,Troy Daniels\danietr01,SG,27,PHO,51,1,760,113,275,0.411,74,194,0.381,39,81,0.481,0.545,18,23,0.783,13,60,73,26,26,5,27,79,318
2018,Anthony Davis\davisan02,C,25,NOP,56,56,1850,530,1026,0.517,48,145,0.331,482,881,0.547,0.54,344,433,0.794,174,498,672,218,88,135,112,132,1452
2018,Deyonta Davis\davisde01,C,22,ATL,9,0,118,15,22,0.682,0,1,0,15,21,0.714,0.682,6,10,0.6,10,26,36,5,3,5,3,12,36
2018,Ed Davis\davised01,C,29,BRK,81,1,1446,186,302,0.616,0,2,0,186,300,0.62,0.616,100,162,0.617,216,478,694,61,35,33,64,226,472
2018,Tyler Davis\davisty01,C,21,OKC,1,0,1,0,1,0,0,0,,0,1,0,0,0,0,,1,0,1,0,0,0,0,0,0
2018,Dewayne Dedmon\dedmode01,C,29,ATL,64,52,1609,259,526,0.492,83,217,0.382,176,309,0.57,0.571,92,113,0.814,105,375,480,90,69,71,84,214,693
2018,Sam Dekker\dekkesa01,PF,24,TOT,47,5,788,120,256,0.469,19,62,0.306,101,194,0.521,0.506,28,46,0.609,53,95,148,46,38,7,24,47,287
2018,Sam Dekker\dekkesa01,PF,24,CLE,9,5,169,22,48,0.458,5,13,0.385,17,35,0.486,0.51,8,10,0.8,9,24,33,9,11,0,5,13,57
2018,Sam Dekker\dekkesa01,PF,24,WAS,38,0,619,98,208,0.471,14,49,0.286,84,159,0.528,0.505,20,36,0.556,44,71,115,37,27,7,19,34,230
2018,Ángel Delgado\delgaan01,C,24,LAC,2,0,15,1,5,0.2,0,0,,1,5,0.2,0.2,1,2,0.5,2,2,4,0,1,0,0,2,3
2018,Matthew Dellavedova\dellama01,PG,28,TOT,48,0,812,98,242,0.405,44,130,0.338,54,112,0.482,0.496,42,52,0.808,6,71,77,181,14,2,68,75,282
2018,Matthew Dellavedova\dellama01,PG,28,MIL,12,0,97,6,19,0.316,4,11,0.364,2,8,0.25,0.421,4,4,1,0,10,10,29,2,0,11,9,20
2018,Matthew Dellavedova\dellama01,PG,28,CLE,36,0,715,92,223,0.413,40,119,0.336,52,104,0.5,0.502,38,48,0.792,6,61,67,152,12,2,57,66,262
2018,Luol Deng\denglu01,SF,33,MIN,22,2,392,59,118,0.5,14,44,0.318,45,74,0.608,0.559,25,35,0.714,20,53,73,18,15,8,14,24,157
2018,DeMar DeRozan\derozde01,SG,29,SAS,77,77,2688,631,1313,0.481,7,45,0.156,624,1268,0.492,0.483,366,441,0.83,54,408,462,475,86,36,199,177,1635
2018,Marcus Derrickson\derrima01,PF,22,GSW,11,0,67,16,33,0.485,10,20,0.5,6,13,0.462,0.636,4,5,0.8,8,5,13,1,0,1,3,9,46
2018,Cheick Diallo\diallch01,PF,22,NOP,64,1,896,168,271,0.62,1,4,0.25,167,267,0.625,0.622,50,67,0.746,75,257,332,33,29,33,49,113,387
2018,Hamidou Diallo\diallha01,SG,20,OKC,51,3,526,75,165,0.455,4,24,0.167,71,141,0.504,0.467,36,59,0.61,38,59,97,17,21,10,23,77,190
2018,Gorgui Dieng\dienggo01,C,29,MIN,76,2,1031,189,377,0.501,19,56,0.339,170,321,0.53,0.527,88,106,0.83,81,230,311,72,48,41,57,134,485
2018,Spencer Dinwiddie\dinwisp01,PG,25,BRK,68,4,1914,366,828,0.442,124,370,0.335,242,458,0.528,0.517,287,356,0.806,26,140,166,311,40,17,152,187,1143
2018,Donte DiVincenzo\divindo01,SG,22,MIL,27,0,411,50,124,0.403,22,83,0.265,28,41,0.683,0.492,9,12,0.75,16,49,65,31,13,6,19,38,131
2018,Luka Dončić\doncilu01,SG,19,DAL,72,72,2318,506,1186,0.427,168,514,0.327,338,672,0.503,0.497,346,485,0.713,86,477,563,429,77,25,247,137,1526
2018,Tyler Dorsey\dorsety01,SG,22,TOT,48,11,698,107,264,0.405,44,132,0.333,63,132,0.477,0.489,38,61,0.623,27,86,113,56,14,2,27,53,296
2018,Tyler Dorsey\dorsety01,SG,22,ATL,27,0,251,32,89,0.36,10,39,0.256,22,50,0.44,0.416,16,26,0.615,9,34,43,17,7,1,10,20,90
2018,Tyler Dorsey\dorsety01,SG,22,MEM,21,11,447,75,175,0.429,34,93,0.366,41,82,0.5,0.526,22,35,0.629,18,52,70,39,7,1,17,33,206
2018,Damyean Dotson\dotsoda01,SG,24,NYK,73,40,2004,290,698,0.415,126,342,0.368,164,356,0.461,0.506,73,98,0.745,34,228,262,135,58,10,71,135,779
2018,PJ Dozier\doziepj01,SG,22,BOS,6,0,51,8,21,0.381,2,8,0.25,6,13,0.462,0.429,1,2,0.5,6,11,17,5,2,0,0,2,19
2018,Goran Dragić\dragigo01,PG,32,MIA,36,22,991,179,433,0.413,57,164,0.348,122,269,0.454,0.479,79,101,0.782,20,91,111,174,30,5,71,81,494
2018,Andre Drummond\drumman01,C,25,DET,79,79,2647,561,1052,0.533,5,38,0.132,556,1014,0.548,0.536,243,412,0.59,423,809,1232,112,136,138,175,272,1370
2018,Jared Dudley\dudleja01,PF,33,BRK,59,25,1220,101,239,0.423,53,151,0.351,48,88,0.545,0.533,32,46,0.696,34,121,155,83,36,16,43,131,287
2018,Kris Dunn\dunnkr01,PG,24,CHI,46,44,1389,215,506,0.425,34,96,0.354,181,410,0.441,0.458,55,69,0.797,19,168,187,277,68,21,104,166,519
2018,Kevin Durant\duranke01,SF,30,GSW,78,78,2702,721,1383,0.521,137,388,0.353,584,995,0.587,0.571,448,506,0.885,33,464,497,457,58,84,225,155,2027
2018,Trevon Duval\duvaltr01,PG,20,MIL,3,0,6,2,3,0.667,1,1,1,1,2,0.5,0.833,0,0,,0,1,1,2,0,0,0,0,5
2018,Vince Edwards\edwarvi01,SF,22,HOU,2,0,16,1,4,0.25,1,4,0.25,0,0,,0.375,0,0,,1,1,2,0,0,0,0,0,3
2018,Henry Ellenson\ellenhe01,PF,22,TOT,19,0,259,39,95,0.411,17,38,0.447,22,57,0.386,0.5,19,25,0.76,5,61,66,16,7,2,9,27,114
2018,Henry Ellenson\ellenhe01,PF,22,DET,2,0,25,4,10,0.4,2,4,0.5,2,6,0.333,0.5,2,2,1,0,9,9,1,0,0,0,2,12
2018,Henry Ellenson\ellenhe01,PF,22,NYK,17,0,234,35,85,0.412,15,34,0.441,20,51,0.392,0.5,17,23,0.739,5,52,57,15,7,2,9,25,102
2018,Wayne Ellington\ellinwa01,SG,31,TOT,53,38,1297,184,457,0.403,138,372,0.371,46,85,0.541,0.554,39,49,0.796,14,93,107,72,54,6,40,92,545
2018,Wayne Ellington\ellinwa01,SG,31,MIA,25,12,533,69,184,0.375,57,155,0.368,12,29,0.414,0.53,14,16,0.875,6,41,47,29,24,3,14,40,209
2018,Wayne Ellington\ellinwa01,SG,31,DET,28,26,764,115,273,0.421,81,217,0.373,34,56,0.607,0.57,25,33,0.758,8,52,60,43,30,3,26,52,336
2018,Joel Embiid\embiijo01,C,24,PHI,64,64,2154,580,1199,0.484,79,263,0.3,501,936,0.535,0.517,522,649,0.804,160,711,871,234,46,122,226,211,1761
2018,James Ennis\ennisja01,SF,28,TOT,58,27,1230,138,294,0.469,55,156,0.353,83,138,0.601,0.563,58,81,0.716,60,122,182,41,41,23,34,150,389
2018,James Ennis\ennisja01,SF,28,HOU,40,25,949,104,211,0.493,44,120,0.367,60,91,0.659,0.597,42,58,0.724,37,80,117,27,38,16,23,111,294
2018,James Ennis\ennisja01,SF,28,PHI,18,2,281,34,83,0.41,11,36,0.306,23,47,0.489,0.476,16,23,0.696,23,42,65,14,3,7,11,39,95
2018,Drew Eubanks\eubandr01,PF,21,SAS,23,0,113,15,26,0.577,0,0,,15,26,0.577,0.577,11,13,0.846,6,28,34,7,2,5,8,11,41
2018,Jacob Evans\evansja02,SG,21,GSW,30,1,204,18,53,0.34,4,15,0.267,14,38,0.368,0.377,0,1,0,6,19,25,23,5,3,11,28,40
2018,Jawun Evans\evansja01,PG,22,TOT,8,0,65,3,14,0.214,0,3,0,3,11,0.273,0.214,0,0,,1,11,12,10,3,0,6,8,6
2018,Jawun Evans\evansja01,PG,22,PHO,7,0,64,3,13,0.231,0,2,0,3,11,0.273,0.231,0,0,,1,11,12,10,3,0,6,8,6
2018,Jawun Evans\evansja01,PG,22,OKC,1,0,1,0,1,0,0,1,0,0,0,,0,0,0,,0,0,0,0,0,0,0,0,0
2018,Tyreke Evans\evansty01,SG,29,IND,69,18,1402,257,660,0.389,77,216,0.356,180,444,0.405,0.448,115,160,0.719,33,168,201,166,58,18,118,117,706
2018,Dante Exum\exumda01,PG,23,UTA,42,1,664,101,241,0.419,18,62,0.29,83,179,0.464,0.456,68,86,0.791,16,52,68,110,14,5,52,69,288
2018,Kenneth Faried\farieke01,C,29,TOT,37,13,728,156,265,0.589,8,25,0.32,148,240,0.617,0.604,64,99,0.646,97,153,250,20,17,23,33,82,384
2018,Kenneth Faried\farieke01,C,29,BRK,12,0,118,25,42,0.595,1,5,0.2,24,37,0.649,0.607,10,16,0.625,15,29,44,2,2,4,6,8,61
2018,Kenneth Faried\farieke01,C,29,HOU,25,13,610,131,223,0.587,7,20,0.35,124,203,0.611,0.603,54,83,0.651,82,124,206,18,15,19,27,74,323
2018,Derrick Favors\favorde01,C,27,UTA,76,70,1766,363,619,0.586,17,78,0.218,346,541,0.64,0.6,154,228,0.675,207,353,560,89,56,106,84,163,897
2018,Cristiano Felício\feliccr01,C,26,CHI,60,0,746,95,179,0.531,0,4,0,95,175,0.543,0.531,50,73,0.685,79,139,218,37,11,7,33,69,240
2018,Raymond Felton\feltora01,PG,34,OKC,33,0,379,55,135,0.407,20,61,0.328,35,74,0.473,0.481,12,13,0.923,4,30,34,52,10,6,14,29,142
2018,Terrance Ferguson\fergute01,SG,20,OKC,74,74,1931,185,431,0.429,106,290,0.366,79,141,0.56,0.552,37,51,0.725,33,108,141,72,40,16,47,231,513
2018,Yogi Ferrell\ferreyo01,PG,25,SAC,71,3,1067,153,352,0.435,54,149,0.362,99,203,0.488,0.511,60,67,0.896,13,96,109,137,36,4,40,64,420
2018,Dorian Finney-Smith\finnedo01,SF,25,DAL,81,26,1985,228,528,0.432,79,254,0.311,149,274,0.544,0.507,73,103,0.709,138,251,389,95,69,36,74,186,608
2018,Bryn Forbes\forbebr01,SG,25,SAS,82,81,2293,361,791,0.456,176,413,0.426,185,378,0.489,0.568,69,78,0.885,18,221,239,175,45,4,80,159,967
2018,Evan Fournier\fournev01,SG,26,ORL,81,81,2553,468,1069,0.438,153,450,0.34,315,619,0.509,0.509,137,170,0.806,38,220,258,295,71,12,154,225,1226
2018,De'Aaron Fox\foxde01,PG,21,SAC,81,81,2546,505,1102,0.458,86,232,0.371,419,870,0.482,0.497,303,417,0.727,43,261,304,590,133,45,227,204,1399
2018,Melvin Frazier\frazime01,SG,22,ORL,10,0,44,7,21,0.333,0,6,0,7,15,0.467,0.333,1,4,0.25,3,2,5,1,1,0,1,6,15
2018,Tim Frazier\fraziti01,PG,28,TOT,59,19,1120,116,261,0.444,37,101,0.366,79,160,0.494,0.515,41,54,0.759,41,127,168,248,30,5,76,112,310
2018,Tim Frazier\fraziti01,PG,28,NOP,47,17,909,88,195,0.451,27,77,0.351,61,118,0.517,0.521,32,41,0.78,32,105,137,206,25,4,60,93,235
2018,Tim Frazier\fraziti01,PG,28,MIL,12,2,211,28,66,0.424,10,24,0.417,18,42,0.429,0.5,9,13,0.692,9,22,31,42,5,1,16,19,75
2018,Jimmer Fredette\fredeji01,SG,29,PHO,6,0,65,8,29,0.276,0,13,0,8,16,0.5,0.276,6,6,1,1,6,7,8,3,0,5,5,22
2018,Channing Frye\fryech01,C,35,CLE,36,6,341,43,117,0.368,32,79,0.405,11,38,0.289,0.504,11,14,0.786,4,48,52,20,6,5,13,44,129
2018,Markelle Fultz\fultzma01,SG,20,PHI,19,15,427,65,155,0.419,4,14,0.286,61,141,0.433,0.432,21,37,0.568,26,44,70,59,17,5,25,52,155
2018,Danilo Gallinari\gallida01,SF,30,LAC,68,68,2059,409,884,0.463,161,372,0.433,248,512,0.484,0.554,367,406,0.904,54,363,417,178,49,23,99,129,1346
2018,Langston Galloway\gallola01,SG,27,DET,80,4,1745,228,587,0.388,135,380,0.355,93,207,0.449,0.503,81,96,0.844,49,122,171,85,37,8,24,135,672
2018,Billy Garrett\garrebi01,SG,24,NYK,4,0,63,11,27,0.407,0,8,0,11,19,0.579,0.407,4,4,1,0,3,3,7,1,1,2,3,26
2018,Marc Gasol\gasolma01,C,34,TOT,79,72,2436,390,870,0.448,99,273,0.363,291,597,0.487,0.505,192,253,0.759,80,547,627,349,84,86,155,217,1071
2018,Marc Gasol\gasolma01,C,34,MEM,53,53,1788,303,683,0.444,76,221,0.344,227,462,0.491,0.499,152,201,0.756,56,399,455,248,60,63,119,147,834
2018,Marc Gasol\gasolma01,C,34,TOR,26,19,648,87,187,0.465,23,52,0.442,64,135,0.474,0.527,40,52,0.769,24,148,172,101,24,23,36,70,237
2018,Pau Gasol\gasolpa01,C,38,TOT,30,6,360,42,94,0.447,6,13,0.462,36,81,0.444,0.479,28,40,0.7,22,115,137,52,5,15,16,29,118
2018,Pau Gasol\gasolpa01,C,38,SAS,27,6,330,41,88,0.466,5,10,0.5,36,78,0.462,0.494,27,38,0.711,22,105,127,50,5,14,14,28,114
2018,Pau Gasol\gasolpa01,C,38,MIL,3,0,30,1,6,0.167,1,3,0.333,0,3,0,0.25,1,2,0.5,0,10,10,2,0,1,2,1,4
2018,Rudy Gay\gayru01,PF,32,SAS,69,51,1842,376,746,0.504,74,184,0.402,302,562,0.537,0.554,120,147,0.816,63,407,470,182,54,34,114,159,946
2018,Paul George\georgpa01,SF,28,OKC,77,77,2841,707,1614,0.438,292,757,0.386,415,857,0.484,0.529,453,540,0.839,105,523,628,318,170,34,205,214,2159
2018,Taj Gibson\gibsota01,PF,33,MIN,70,57,1686,304,537,0.566,11,34,0.324,293,503,0.583,0.576,134,177,0.757,172,286,458,84,53,39,73,186,753
2018,Harry Giles\gilesha01,PF,20,SAC,58,0,820,175,348,0.503,0,6,0,175,342,0.512,0.503,58,91,0.637,66,156,222,85,31,22,73,150,408
2018,Shai Gilgeous-Alexander\gilgesh01,PG,20,LAC,82,73,2174,341,716,0.476,51,139,0.367,290,577,0.503,0.512,156,195,0.8,57,175,232,270,96,45,141,175,889
2018,Rudy Gobert\goberru01,C,26,UTA,81,80,2577,476,712,0.669,0,0,,476,712,0.669,0.669,332,522,0.636,309,732,1041,161,66,187,130,231,1284
2018,Brandon Goodwin\goodwbr01,PG,23,DEN,16,0,57,6,23,0.261,2,6,0.333,4,17,0.235,0.304,9,11,0.818,1,2,3,14,0,0,3,7,23
2018,Aaron Gordon\gordoaa01,PF,23,ORL,78,78,2633,470,1046,0.449,121,347,0.349,349,699,0.499,0.507,185,253,0.731,129,445,574,289,57,56,162,172,1246
2018,Eric Gordon\gordoer01,SG,30,HOU,68,53,2158,384,938,0.409,216,600,0.36,168,338,0.497,0.525,119,152,0.783,17,131,148,129,41,27,90,143,1103
2018,Marcin Gortat\gortama01,C,34,LAC,47,43,751,99,186,0.532,0,0,,99,186,0.532,0.532,35,48,0.729,67,194,261,65,6,24,50,92,233
2018,Devonte' Graham\grahade01,PG,23,CHO,46,3,676,74,216,0.343,34,121,0.281,40,95,0.421,0.421,35,46,0.761,10,53,63,121,23,2,30,48,217
2018,Treveon Graham\grahatr01,SG,25,BRK,35,21,715,64,191,0.335,38,128,0.297,26,63,0.413,0.435,18,22,0.818,23,84,107,34,13,7,17,68,184
2018,Jerami Grant\grantje01,PF,24,OKC,80,77,2612,409,823,0.497,115,293,0.392,294,530,0.555,0.567,157,221,0.71,96,321,417,79,61,100,67,214,1090
2018,Jerian Grant\grantje02,PG,26,ORL,60,1,939,92,220,0.418,40,110,0.364,52,110,0.473,0.509,26,40,0.65,19,79,98,156,44,6,51,78,250
2018,Donte Grantham\grantdo01,SF,23,OKC,3,0,2,0,2,0,0,2,0,0,0,,0,0,0,,0,0,0,0,0,0,0,0,0
2018,Danny Green\greenda02,SG,31,TOR,80,80,2216,293,630,0.465,198,435,0.455,95,195,0.487,0.622,37,44,0.841,60,257,317,126,73,53,75,171,821
2018,Draymond Green\greendr01,PF,28,GSW,66,66,2065,188,422,0.445,47,165,0.285,141,257,0.549,0.501,63,91,0.692,60,421,481,454,95,70,169,197,486
2018,Gerald Green\greenge01,SG,33,HOU,73,0,1473,231,578,0.4,156,441,0.354,75,137,0.547,0.535,57,68,0.838,30,152,182,40,33,27,55,126,675
2018,JaMychal Green\greenja01,PF,28,TOT,65,6,1371,230,476,0.483,71,176,0.403,159,300,0.53,0.558,80,101,0.792,104,305,409,50,45,34,87,193,611
2018,JaMychal Green\greenja01,PF,28,MEM,41,4,900,151,312,0.484,38,96,0.396,113,216,0.523,0.545,63,80,0.788,72,180,252,36,33,26,64,123,403
2018,JaMychal Green\greenja01,PF,28,LAC,24,2,471,79,164,0.482,33,80,0.413,46,84,0.548,0.582,17,21,0.81,32,125,157,14,12,8,23,70,208
2018,Jeff Green\greenje02,PF,32,WAS,77,44,2097,326,687,0.475,111,320,0.347,215,367,0.586,0.555,183,206,0.888,57,252,309,137,43,39,101,160,946
2018,Blake Griffin\griffbl01,PF,29,DET,75,75,2622,619,1341,0.462,189,522,0.362,430,819,0.525,0.532,414,550,0.753,100,465,565,402,52,28,253,199,1841
2018,Daniel Hamilton\hamilda02,SG,23,ATL,19,3,204,23,60,0.383,8,23,0.348,15,37,0.405,0.45,3,6,0.5,10,37,47,22,6,1,16,19,57
2018,Dusty Hannahs\hannadu01,SG,25,MEM,2,0,26,3,12,0.25,0,5,0,3,7,0.429,0.25,2,2,1,0,1,1,5,1,0,1,1,8
2018,Tim Hardaway\hardati02,SG,26,TOT,65,63,2057,390,993,0.393,162,477,0.34,228,516,0.442,0.474,232,276,0.841,33,189,222,159,54,8,105,141,1174
2018,Tim Hardaway\hardati02,SG,26,NYK,46,46,1499,282,726,0.388,117,337,0.347,165,389,0.424,0.469,199,233,0.854,26,135,161,122,42,6,81,106,880
2018,Tim Hardaway\hardati02,SG,26,DAL,19,17,558,108,267,0.404,45,140,0.321,63,127,0.496,0.489,33,43,0.767,7,54,61,37,12,2,24,35,294
2018,James Harden\hardeja01,PG,29,HOU,78,78,2867,843,1909,0.442,378,1028,0.368,465,881,0.528,0.541,754,858,0.879,66,452,518,586,158,58,387,244,2818
2018,Maurice Harkless\harklma01,SF,25,POR,60,53,1415,189,388,0.487,33,120,0.275,156,268,0.582,0.53,49,73,0.671,77,192,269,74,67,53,45,163,460
2018,Montrezl Harrell\harremo01,C,25,LAC,82,5,2158,546,888,0.615,3,17,0.176,543,871,0.623,0.617,266,414,0.643,184,351,535,162,71,110,132,255,1361
2018,Devin Harris\harride01,PG,35,DAL,68,2,1071,132,347,0.38,62,200,0.31,70,147,0.476,0.47,102,134,0.761,12,100,112,122,35,16,56,133,428
2018,Gary Harris\harriga01,SG,24,DEN,57,48,1639,270,637,0.424,82,242,0.339,188,395,0.476,0.488,115,144,0.799,41,119,160,127,55,19,68,113,737
2018,Joe Harris\harrijo01,SG,27,BRK,76,76,2293,374,748,0.5,183,386,0.474,191,362,0.528,0.622,110,133,0.827,52,239,291,181,38,17,121,182,1041
2018,Tobias Harris\harrito02,PF,26,TOT,82,82,2847,611,1254,0.487,156,393,0.397,455,861,0.528,0.549,266,307,0.866,69,576,645,229,51,37,151,184,1644
2018,Tobias Harris\harrito02,PF,26,LAC,55,55,1903,424,855,0.496,112,258,0.434,312,597,0.523,0.561,192,219,0.877,37,395,432,150,40,24,109,123,1152
2018,Tobias Harris\harrito02,PF,26,PHI,27,27,944,187,399,0.469,44,135,0.326,143,264,0.542,0.524,74,88,0.841,32,181,213,79,11,13,42,61,492
2018,Andrew Harrison\harrian01,PG,24,TOT,17,0,187,16,53,0.302,5,25,0.2,11,28,0.393,0.349,17,18,0.944,6,14,20,24,4,2,12,34,54
2018,Andrew Harrison\harrian01,PG,24,MEM,1,0,5,1,2,0.5,0,1,0,1,1,1,0.5,0,0,,0,0,0,0,0,0,0,1,2
2018,Andrew Harrison\harrian01,PG,24,CLE,10,0,144,12,39,0.308,3,14,0.214,9,25,0.36,0.346,16,16,1,4,11,15,17,4,2,10,26,43
2018,Andrew Harrison\harrian01,PG,24,NOP,6,0,38,3,12,0.25,2,10,0.2,1,2,0.5,0.333,1,2,0.5,2,3,5,7,0,0,2,7,9
2018,Shaquille Harrison\harrish01,SG,25,CHI,73,11,1430,184,426,0.432,24,89,0.27,160,337,0.475,0.46,82,123,0.667,33,189,222,139,89,30,60,124,474
2018,Josh Hart\hartjo01,SG,23,LAL,67,22,1715,189,464,0.407,92,274,0.336,97,190,0.511,0.506,55,80,0.688,35,213,248,93,64,40,58,147,525
2018,Isaiah Hartenstein\harteis01,PF,20,HOU,28,0,221,20,41,0.488,2,6,0.333,18,35,0.514,0.512,11,14,0.786,21,26,47,15,7,12,13,56,53
2018,Udonis Haslem\hasleud01,C,38,MIA,10,1,74,11,33,0.333,0,12,0,11,21,0.524,0.333,3,4,0.75,3,24,27,2,0,0,3,9,25
2018,Gordon Hayward\haywago01,PF,28,BOS,72,18,1863,296,635,0.466,77,231,0.333,219,404,0.542,0.527,156,187,0.834,51,271,322,244,62,23,105,104,825
2018,John Henson\hensojo01,C,28,MIL,14,0,188,31,67,0.463,11,31,0.355,20,36,0.556,0.545,6,10,0.6,16,55,71,14,7,11,12,16,79
2018,Juan Hernangómez\hernaju01,PF,23,DEN,70,25,1358,138,314,0.439,66,181,0.365,72,133,0.541,0.545,66,86,0.767,64,201,265,55,27,24,37,94,408
2018,Willy Hernangómez\hernawi01,C,24,CHO,58,3,812,153,295,0.519,15,39,0.385,138,256,0.539,0.544,100,144,0.694,117,194,311,60,16,20,58,98,421
2018,Mario Hezonja\hezonma01,SF,23,NYK,58,24,1206,191,464,0.412,42,152,0.276,149,312,0.478,0.457,87,114,0.763,28,211,239,88,57,8,88,110,511
2018,Isaiah Hicks\hicksis01,PF,24,NYK,3,0,32,4,8,0.5,0,0,,4,8,0.5,0.5,4,5,0.8,2,5,7,2,1,3,1,5,12
2018,Buddy Hield\hieldbu01,SG,26,SAC,82,82,2615,623,1360,0.458,278,651,0.427,345,709,0.487,0.56,171,193,0.886,106,306,412,205,58,33,146,202,1695
2018,Haywood Highsmith\highsha01,SF,22,PHI,5,0,40,4,10,0.4,1,5,0.2,3,5,0.6,0.45,0,2,0,0,5,5,2,1,0,1,1,9
2018,Nenê Hilário\hilarne01,C,36,HOU,42,2,546,60,116,0.517,0,3,0,60,113,0.531,0.517,31,47,0.66,34,89,123,26,18,15,11,87,151
2018,George Hill\hillge01,PG,32,TOT,60,13,1302,170,376,0.452,48,153,0.314,122,223,0.547,0.516,70,85,0.824,39,109,148,135,52,8,51,102,458
2018,George Hill\hillge01,PG,32,CLE,13,13,344,55,107,0.514,13,28,0.464,42,79,0.532,0.575,17,20,0.85,12,15,27,36,12,1,20,35,140
2018,George Hill\hillge01,PG,32,MIL,47,0,958,115,269,0.428,35,125,0.28,80,144,0.556,0.493,53,65,0.815,27,94,121,99,40,7,31,67,318
2018,Solomon Hill\hillso01,SF,27,NOP,44,15,878,68,178,0.382,32,101,0.317,36,77,0.468,0.472,23,32,0.719,34,99,133,55,23,10,31,80,191
2018,Aaron Holiday\holidaa01,PG,22,IND,50,0,646,105,262,0.401,43,127,0.339,62,135,0.459,0.483,41,50,0.82,5,62,67,87,21,13,40,71,294
2018,Jrue Holiday\holidjr01,SG,28,NOP,67,67,2402,547,1159,0.472,118,363,0.325,429,796,0.539,0.523,208,271,0.768,75,259,334,518,109,54,210,148,1420
2018,Justin Holiday\holidju01,SG,29,TOT,82,77,2607,300,777,0.386,162,465,0.348,138,312,0.442,0.49,95,106,0.896,46,277,323,146,121,36,104,164,857
2018,Justin Holiday\holidju01,SG,29,CHI,38,38,1325,151,394,0.383,97,270,0.359,54,124,0.435,0.506,41,46,0.891,19,150,169,85,67,21,47,79,440
2018,Justin Holiday\holidju01,SG,29,MEM,44,39,1282,149,383,0.389,65,195,0.333,84,188,0.447,0.474,54,60,0.9,27,127,154,61,54,15,57,85,417
2018,John Holland\hollajo02,SF,30,CLE,1,0,1,0,0,,0,0,,0,0,,,0,0,,0,0,0,0,0,0,0,0,0
2018,Rondae Hollis-Jefferson\holliro01,SF,24,BRK,59,21,1234,200,487,0.411,9,49,0.184,191,438,0.436,0.42,118,183,0.645,83,227,310,96,44,27,68,107,527
2018,Richaun Holmes\holmeri01,C,25,PHO,70,4,1184,222,365,0.608,0,0,,222,365,0.608,0.608,128,175,0.731,115,216,331,60,42,79,52,194,572
2018,Rodney Hood\hoodro01,SG,26,TOT,72,49,1893,292,671,0.435,84,236,0.356,208,435,0.478,0.498,137,155,0.884,25,132,157,126,59,12,55,146,805
2018,Rodney Hood\hoodro01,SG,26,CLE,45,45,1234,194,454,0.427,55,152,0.362,139,302,0.46,0.488,104,114,0.912,18,94,112,92,38,5,36,101,547
2018,Rodney Hood\hoodro01,SG,26,POR,27,4,659,98,217,0.452,29,84,0.345,69,133,0.519,0.518,33,41,0.805,7,38,45,34,21,7,19,45,258
2018,Al Horford\horfoal01,C,32,BOS,68,68,1973,387,723,0.535,73,203,0.36,314,520,0.604,0.586,78,95,0.821,120,338,458,283,59,86,102,126,925
2018,Danuel House\houseda01,SF,25,HOU,39,13,979,118,252,0.468,74,178,0.416,44,74,0.595,0.615,56,71,0.789,25,115,140,40,21,11,35,80,366
2018,Dwight Howard\howardw01,C,33,WAS,9,9,230,43,69,0.623,0,0,,43,69,0.623,0.623,29,48,0.604,24,59,83,4,7,4,16,34,115
2018,Kevin Huerter\huertke01,SG,20,ATL,75,59,2048,275,657,0.419,136,353,0.385,139,304,0.457,0.522,41,56,0.732,60,185,245,214,65,25,109,155,727
2018,Isaac Humphries\humphis01,C,21,ATL,5,1,56,6,21,0.286,3,11,0.273,3,10,0.3,0.357,0,0,,4,7,11,0,1,0,0,7,15
2018,R.J. Hunter\hunterj01,SG,25,BOS,1,0,26,6,13,0.462,4,10,0.4,2,3,0.667,0.615,1,2,0.5,1,2,3,3,1,0,0,3,17
2018,Chandler Hutchison\hutchch01,SF,22,CHI,44,14,895,96,209,0.459,14,50,0.28,82,159,0.516,0.493,23,38,0.605,31,154,185,34,23,6,25,59,229
2018,Serge Ibaka\ibakase01,C,29,TOR,74,51,2010,464,877,0.529,49,169,0.29,415,708,0.586,0.557,135,177,0.763,156,445,601,99,29,103,114,211,1112
2018,Andre Iguodala\iguodan01,SF,35,GSW,68,13,1578,151,302,0.5,48,144,0.333,103,158,0.652,0.579,39,67,0.582,48,204,252,216,61,51,52,95,389
2018,Ersan İlyasova\ilyaser01,PF,31,MIL,67,7,1231,167,381,0.438,58,160,0.363,109,221,0.493,0.514,61,74,0.824,94,208,302,52,32,20,48,172,453
2018,Joe Ingles\inglejo01,PF,31,UTA,82,82,2568,359,802,0.448,189,483,0.391,170,319,0.533,0.565,87,123,0.707,35,295,330,469,98,20,193,180,994
2018,Andre Ingram\ingraan01,SG,33,LAL,4,0,15,0,6,0,0,3,0,0,3,0,0,0,0,,1,1,2,0,1,0,1,0,0
2018,Brandon Ingram\ingrabr01,SF,21,LAL,52,52,1760,362,729,0.497,31,94,0.33,331,635,0.521,0.518,195,289,0.675,41,226,267,154,28,31,129,149,950
2018,Kyrie Irving\irvinky01,PG,26,BOS,67,67,2214,604,1241,0.487,174,434,0.401,430,807,0.533,0.557,214,245,0.873,71,264,335,464,103,34,172,167,1596
2018,Jonathan Isaac\isaacjo01,PF,21,ORL,75,64,1996,262,611,0.429,86,266,0.323,176,345,0.51,0.499,110,135,0.815,99,312,411,80,59,98,75,143,720
2018,Wesley Iwundu\iwundwe01,SF,24,ORL,68,13,1233,113,274,0.412,29,79,0.367,84,195,0.431,0.465,84,103,0.816,37,147,184,73,28,22,44,123,339
2018,Demetrius Jackson\jacksde01,PG,24,PHI,6,0,39,8,15,0.533,2,6,0.333,6,9,0.667,0.6,4,4,1,2,1,3,5,2,0,1,4,22
2018,Frank Jackson\jacksfr01,PG,20,NOP,61,16,1169,194,447,0.434,53,169,0.314,141,278,0.507,0.493,54,73,0.74,25,109,134,69,25,2,48,92,495
2018,Jaren Jackson\jacksja02,PF,19,MEM,58,56,1515,298,589,0.506,51,142,0.359,247,447,0.553,0.549,151,197,0.766,73,199,272,64,52,82,98,220,798
2018,Josh Jackson\jacksjo02,SG,21,PHO,79,29,1988,347,841,0.413,73,225,0.324,274,616,0.445,0.456,143,213,0.671,66,281,347,183,74,56,173,209,910
2018,Justin Jackson\jacksju01,SF,23,TOT,81,14,1614,217,485,0.447,87,245,0.355,130,240,0.542,0.537,62,79,0.785,44,168,212,96,32,14,29,99,583
2018,Justin Jackson\jacksju01,SF,23,SAC,52,3,1083,125,295,0.424,55,159,0.346,70,136,0.515,0.517,41,50,0.82,25,121,146,68,23,13,22,67,346
2018,Justin Jackson\jacksju01,SF,23,DAL,29,11,531,92,190,0.484,32,86,0.372,60,104,0.577,0.568,21,29,0.724,19,47,66,28,9,1,7,32,237
2018,Reggie Jackson\jacksre01,PG,28,DET,82,82,2289,441,1047,0.421,174,471,0.369,267,576,0.464,0.504,204,236,0.864,45,171,216,344,55,9,148,208,1260
2018,LeBron James\jamesle01,SF,34,LAL,55,55,1937,558,1095,0.51,111,327,0.339,447,768,0.582,0.56,278,418,0.665,57,408,465,454,72,33,197,94,1505
2018,Amile Jefferson\jeffeam01,PF,25,ORL,12,0,68,10,16,0.625,0,0,,10,16,0.625,0.625,7,8,0.875,6,15,21,3,3,3,1,8,27
2018,John Jenkins\jenkijo01,SG,27,TOT,26,0,333,42,105,0.4,22,58,0.379,20,47,0.426,0.505,15,18,0.833,6,31,37,22,0,2,9,10,121
2018,John Jenkins\jenkijo01,SG,27,WAS,4,0,14,2,2,1,2,2,1,0,0,,1.5,0,0,,0,1,1,1,0,0,0,0,6
2018,John Jenkins\jenkijo01,SG,27,NYK,22,0,319,40,103,0.388,20,56,0.357,20,47,0.426,0.485,15,18,0.833,6,30,36,21,0,2,9,10,115
2018,Jonas Jerebko\jerebjo01,PF,31,GSW,73,6,1218,163,355,0.459,69,188,0.367,94,167,0.563,0.556,64,80,0.8,72,216,288,96,27,18,43,137,459
2018,Alize Johnson\johnsal02,PF,22,IND,14,0,64,4,16,0.25,1,2,0.5,3,14,0.214,0.281,4,8,0.5,4,15,19,1,1,3,0,7,13
2018,Amir Johnson\johnsam01,C,31,PHI,51,6,529,79,157,0.503,12,40,0.3,67,117,0.573,0.541,31,41,0.756,47,100,147,60,16,13,45,99,201
2018,B.J. Johnson\johnsbj01,SF,23,TOT,7,0,49,9,18,0.5,3,7,0.429,6,11,0.545,0.583,2,2,1,2,6,8,0,2,0,2,4,23
2018,B.J. Johnson\johnsbj01,SF,23,ATL,6,0,43,8,16,0.5,3,6,0.5,5,10,0.5,0.594,2,2,1,2,6,8,0,2,0,2,3,21
2018,B.J. Johnson\johnsbj01,SF,23,SAC,1,0,6,1,2,0.5,0,1,0,1,1,1,0.5,0,0,,0,0,0,0,0,0,0,1,2
2018,James Johnson\johnsja01,PF,31,MIA,55,33,1164,164,379,0.433,50,149,0.336,114,230,0.496,0.499,50,70,0.714,22,154,176,135,35,27,74,114,428
2018,Stanley Johnson\johnsst04,SF,22,TOT,66,7,1208,171,440,0.389,62,215,0.288,109,225,0.484,0.459,50,64,0.781,34,183,217,88,60,14,81,114,454
2018,Stanley Johnson\johnsst04,SF,22,DET,48,7,961,133,349,0.381,51,181,0.282,82,168,0.488,0.454,41,51,0.804,25,150,175,60,48,13,55,92,358
2018,Stanley Johnson\johnsst04,SF,22,NOP,18,0,247,38,91,0.418,11,34,0.324,27,57,0.474,0.478,9,13,0.692,9,33,42,28,12,1,26,22,96
2018,Tyler Johnson\johnsty01,PG,26,TOT,57,22,1529,217,526,0.413,90,260,0.346,127,266,0.477,0.498,95,127,0.748,34,139,173,166,54,27,77,97,619
2018,Tyler Johnson\johnsty01,PG,26,MIA,44,10,1123,171,401,0.426,72,204,0.353,99,197,0.503,0.516,61,88,0.693,19,102,121,112,40,21,63,72,475
2018,Tyler Johnson\johnsty01,PG,26,PHO,13,12,406,46,125,0.368,18,56,0.321,28,69,0.406,0.44,34,39,0.872,15,37,52,54,14,6,14,25,144
2018,Wesley Johnson\johnswe01,SF,31,TOT,38,13,534,45,128,0.352,25,76,0.329,20,52,0.385,0.449,13,19,0.684,12,60,72,23,14,12,18,63,128
2018,Wesley Johnson\johnswe01,SF,31,NOP,26,13,377,35,88,0.398,19,50,0.38,16,38,0.421,0.506,6,9,0.667,10,44,54,16,12,7,12,45,95
2018,Wesley Johnson\johnswe01,SF,31,WAS,12,0,157,10,40,0.25,6,26,0.231,4,14,0.286,0.325,7,10,0.7,2,16,18,7,2,5,6,18,33
2018,Nikola Jokić\jokicni01,C,23,DEN,80,80,2504,616,1206,0.511,83,270,0.307,533,936,0.569,0.545,289,352,0.821,228,637,865,580,108,55,248,228,1604
2018,Damian Jones\jonesda03,C,23,GSW,24,22,410,53,74,0.716,0,0,,53,74,0.716,0.716,24,37,0.649,31,44,75,28,12,25,16,63,130
2018,Derrick Jones\jonesde02,SF,21,MIA,60,14,1153,160,324,0.494,28,91,0.308,132,233,0.567,0.537,74,122,0.607,96,144,240,37,46,42,43,123,422
2018,Jalen Jones\jonesja04,SF,25,CLE,16,0,214,26,62,0.419,10,28,0.357,16,34,0.471,0.5,19,27,0.704,11,23,34,7,9,2,8,27,81
2018,Jemerrio Jones\jonesje01,SF,23,LAL,6,2,143,12,33,0.364,2,10,0.2,10,23,0.435,0.394,1,2,0.5,16,33,49,13,7,5,5,10,27
2018,Terrence Jones\joneste01,PF,27,HOU,2,0,5,1,4,0.25,0,2,0,1,2,0.5,0.25,0,1,0,0,4,4,0,0,0,1,1,2
2018,Tyus Jones\jonesty01,PG,22,MIN,68,23,1560,185,446,0.415,40,126,0.317,145,320,0.453,0.46,58,69,0.841,23,111,134,327,81,5,47,78,468
2018,DeAndre Jordan\jordade01,C,30,TOT,69,69,2047,286,446,0.641,0,0,,286,446,0.641,0.641,186,264,0.705,225,677,902,156,42,73,153,167,758
2018,DeAndre Jordan\jordade01,C,30,DAL,50,50,1554,208,323,0.644,0,0,,208,323,0.644,0.644,135,198,0.682,161,525,686,99,33,53,111,125,551
2018,DeAndre Jordan\jordade01,C,30,NYK,19,19,493,78,123,0.634,0,0,,78,123,0.634,0.634,51,66,0.773,64,152,216,57,9,20,42,42,207
2018,Cory Joseph\josepco01,PG,27,IND,82,9,2063,226,548,0.412,55,171,0.322,171,377,0.454,0.463,30,43,0.698,39,240,279,321,94,22,80,131,537
2018,Frank Kaminsky\kaminfr01,C,25,CHO,47,0,755,138,298,0.463,50,139,0.36,88,159,0.553,0.547,79,107,0.738,39,124,163,63,12,12,41,68,405
2018,Enes Kanter\kanteen01,C,26,TOT,67,31,1640,375,683,0.549,10,34,0.294,365,649,0.562,0.556,155,197,0.787,257,402,659,116,32,26,118,167,915
2018,Enes Kanter\kanteen01,C,26,NYK,44,23,1128,251,468,0.536,7,22,0.318,244,446,0.547,0.544,105,129,0.814,171,290,461,84,18,17,79,106,614
2018,Enes Kanter\kanteen01,C,26,POR,23,8,512,124,215,0.577,3,12,0.25,121,203,0.596,0.584,50,68,0.735,86,112,198,32,14,9,39,61,301
2018,Luke Kennard\kennalu01,SG,22,DET,63,10,1437,228,520,0.438,106,269,0.394,122,251,0.486,0.54,51,61,0.836,12,171,183,114,26,10,57,92,613
2018,Michael Kidd-Gilchrist\kiddgmi01,PF,25,CHO,64,3,1179,158,332,0.476,16,47,0.34,142,285,0.498,0.5,95,123,0.772,88,158,246,61,32,39,43,156,427
2018,George King\kingge03,SF,25,PHO,1,0,6,0,0,,0,0,,0,0,,,0,0,,0,1,1,0,0,0,0,0,0
2018,Maxi Kleber\klebima01,PF,27,DAL,71,18,1502,175,386,0.453,77,218,0.353,98,168,0.583,0.553,58,74,0.784,90,239,329,70,36,78,54,143,485
2018,Brandon Knight\knighbr03,PG,27,TOT,39,26,736,99,260,0.381,41,129,0.318,58,131,0.443,0.46,27,34,0.794,10,49,59,71,21,2,30,62,266
2018,Brandon Knight\knighbr03,PG,27,HOU,12,0,118,11,47,0.234,5,32,0.156,6,15,0.4,0.287,9,11,0.818,1,8,9,9,2,0,5,14,36
2018,Brandon Knight\knighbr03,PG,27,CLE,27,26,618,88,213,0.413,36,97,0.371,52,116,0.448,0.498,18,23,0.783,9,41,50,62,19,2,25,48,230
2018,Kevin Knox\knoxke01,PF,19,NYK,75,57,2158,338,914,0.37,125,364,0.343,213,550,0.387,0.438,162,226,0.717,61,274,335,82,43,24,114,175,963
2018,Furkan Korkmaz\korkmfu01,SG,21,PHI,48,7,679,98,245,0.4,47,144,0.326,51,101,0.505,0.496,36,44,0.818,16,91,107,52,29,2,25,62,279
2018,Luke Kornet\kornelu01,PF,23,NYK,46,18,784,107,283,0.378,70,193,0.363,37,90,0.411,0.502,38,46,0.826,28,107,135,54,27,42,25,41,322
2018,Kyle Korver\korveky01,SG-PF,37,TOT,70,0,1334,201,483,0.416,138,348,0.397,63,135,0.467,0.559,60,73,0.822,9,153,162,81,25,12,59,106,600
2018,Kyle Korver\korveky01,PF,37,CLE,16,0,251,35,76,0.461,25,54,0.463,10,22,0.455,0.625,13,16,0.813,0,29,29,17,3,2,17,22,108
2018,Kyle Korver\korveky01,SG,37,UTA,54,0,1083,166,407,0.408,113,294,0.384,53,113,0.469,0.547,47,57,0.825,9,124,133,64,22,10,42,84,492
2018,Kosta Koufos\koufoko01,C,29,SAC,42,1,502,73,153,0.477,0,0,,73,153,0.477,0.477,10,24,0.417,52,125,177,36,15,18,27,68,156
2018,Rodions Kurucs\kurucro01,SF,20,BRK,63,46,1294,202,449,0.45,58,184,0.315,144,265,0.543,0.514,72,92,0.783,56,190,246,52,41,25,77,146,534
2018,Kyle Kuzma\kuzmaky01,PF,23,LAL,70,68,2314,496,1087,0.456,128,422,0.303,368,665,0.553,0.515,188,250,0.752,60,322,382,178,41,26,133,170,1308
2018,Skal Labissière\labissk01,PF,22,TOT,22,1,176,26,49,0.531,6,13,0.462,20,36,0.556,0.592,9,17,0.529,9,34,43,11,5,6,11,29,67
2018,Skal Labissière\labissk01,PF,22,SAC,13,0,113,13,30,0.433,4,11,0.364,9,19,0.474,0.5,6,11,0.545,4,20,24,6,2,3,7,21,36
2018,Skal Labissière\labissk01,PF,22,POR,9,1,63,13,19,0.684,2,2,1,11,17,0.647,0.737,3,6,0.5,5,14,19,5,3,3,4,8,31
2018,Jeremy Lamb\lambje01,SG,26,CHO,79,55,2250,431,979,0.44,115,330,0.348,316,649,0.487,0.499,231,260,0.888,65,369,434,172,88,32,80,140,1208
2018,Zach LaVine\lavinza01,SG,23,CHI,63,62,2171,530,1135,0.467,120,321,0.374,410,814,0.504,0.52,312,375,0.832,40,254,294,283,60,26,215,140,1492
2018,Jake Layman\laymaja01,SF,24,POR,71,33,1327,216,424,0.509,59,181,0.326,157,243,0.646,0.579,50,71,0.704,56,161,217,53,31,30,46,116,541
2018,T.J. Leaf\leaftj01,PF,21,IND,58,1,522,99,183,0.541,8,31,0.258,91,152,0.599,0.563,19,31,0.613,43,82,125,24,9,19,12,35,225
2018,Courtney Lee\leeco01,SG,33,TOT,34,6,428,53,129,0.411,16,55,0.291,37,74,0.5,0.473,14,21,0.667,9,45,54,37,21,3,14,32,136
2018,Courtney Lee\leeco01,SG,33,NYK,12,2,160,21,47,0.447,5,16,0.313,16,31,0.516,0.5,9,14,0.643,6,21,27,16,8,2,5,13,56
2018,Courtney Lee\leeco01,SG,33,DAL,22,4,268,32,82,0.39,11,39,0.282,21,43,0.488,0.457,5,7,0.714,3,24,27,21,13,1,9,19,80
2018,Damion Lee\leeda03,SG,26,GSW,32,0,375,56,127,0.441,27,68,0.397,29,59,0.492,0.547,19,22,0.864,8,56,64,13,13,0,11,28,158
2018,Walt Lemon\lemonwa01,PG,26,CHI,6,3,167,38,87,0.437,2,5,0.4,36,82,0.439,0.448,8,11,0.727,4,23,27,30,11,1,10,14,86
2018,Alex Len\lenal01,C,25,ATL,77,31,1544,320,648,0.494,74,204,0.363,246,444,0.554,0.551,140,216,0.648,158,266,424,86,27,69,97,200,854
2018,Kawhi Leonard\leonaka01,SF,27,TOR,60,60,2040,560,1129,0.496,112,302,0.371,448,827,0.542,0.546,364,426,0.854,78,361,439,199,106,24,121,87,1596
2018,Meyers Leonard\leoname01,C,26,POR,61,2,878,132,242,0.545,50,111,0.45,82,131,0.626,0.649,43,51,0.843,49,184,233,75,13,9,43,105,357
2018,Jon Leuer\leuerjo01,PF,29,DET,41,1,402,66,113,0.584,1,11,0.091,65,102,0.637,0.588,23,31,0.742,27,70,97,14,12,4,23,60,156
2018,Caris LeVert\leverca01,SF,24,BRK,40,25,1063,207,483,0.429,48,154,0.312,159,329,0.483,0.478,85,123,0.691,35,116,151,156,42,14,69,77,547
2018,Damian Lillard\lillada01,PG,28,POR,80,80,2838,681,1533,0.444,237,643,0.369,444,890,0.499,0.522,468,513,0.912,68,303,371,551,88,34,212,148,2067
2018,Jeremy Lin\linje01,PG,30,TOT,74,4,1436,238,541,0.44,55,187,0.294,183,354,0.517,0.491,176,210,0.838,22,157,179,231,47,13,124,144,707
2018,Jeremy Lin\linje01,PG,30,ATL,51,1,1003,180,386,0.466,44,132,0.333,136,254,0.535,0.523,142,168,0.845,16,103,119,181,38,7,98,96,546
2018,Jeremy Lin\linje01,PG,30,TOR,23,3,433,58,155,0.374,11,55,0.2,47,100,0.47,0.41,34,42,0.81,6,54,60,50,9,6,26,48,161
2018,Shaun Livingston\livinsh01,PG,33,GSW,64,0,967,109,210,0.519,0,2,0,109,208,0.524,0.519,40,51,0.784,42,75,117,114,31,27,38,74,258
2018,Zach Lofton\loftoza01,SG,26,DET,1,0,4,0,1,0,0,1,0,0,0,,0,0,0,,0,0,0,0,1,0,1,0,0
2018,Kevon Looney\looneke01,C,22,GSW,80,24,1481,217,347,0.625,1,10,0.1,216,337,0.641,0.627,65,105,0.619,194,223,417,123,46,53,51,211,500
2018,Brook Lopez\lopezbr01,C,30,MIL,81,81,2322,355,786,0.452,187,512,0.365,168,274,0.613,0.571,112,133,0.842,33,363,396,98,51,179,82,189,1009
2018,Robin Lopez\lopezro01,C,30,CHI,74,36,1606,304,535,0.568,7,31,0.226,297,504,0.589,0.575,89,123,0.724,140,146,286,89,11,78,96,124,704
2018,Kevin Love\loveke01,PF,30,CLE,22,21,598,109,283,0.385,53,147,0.361,56,136,0.412,0.479,103,114,0.904,33,206,239,48,6,5,42,54,374
2018,Kyle Lowry\lowryky01,PG,32,TOR,65,65,2213,304,739,0.411,157,453,0.347,147,286,0.514,0.518,161,194,0.83,41,271,312,564,91,31,182,166,926
2018,Jordan Loyd\loydjo01,PG,25,TOR,12,0,55,8,18,0.444,4,8,0.5,4,10,0.4,0.556,9,11,0.818,1,8,9,6,0,0,2,5,29
2018,Kalin Lucas\lucaska01,PG,29,DET,1,0,6,0,1,0,0,1,0,0,0,,0,2,2,1,0,3,3,1,0,0,0,1,2
2018,Timothé Luwawu-Cabarrot\luwawti01,SF,23,TOT,50,7,669,82,218,0.376,36,116,0.31,46,102,0.451,0.459,31,41,0.756,11,86,97,26,19,8,21,73,231
2018,Timothé Luwawu-Cabarrot\luwawti01,SF,23,OKC,21,1,123,13,43,0.302,5,22,0.227,8,21,0.381,0.36,4,6,0.667,4,14,18,4,4,1,5,14,35
2018,Timothé Luwawu-Cabarrot\luwawti01,SF,23,CHI,29,6,546,69,175,0.394,31,94,0.33,38,81,0.469,0.483,27,35,0.771,7,72,79,22,15,7,16,59,196
2018,Tyler Lydon\lydonty01,PF,22,DEN,25,0,94,9,18,0.5,4,10,0.4,5,8,0.625,0.611,1,3,0.333,7,11,18,6,2,0,4,10,23
2018,Trey Lyles\lylestr01,PF,23,DEN,64,2,1120,207,495,0.418,51,200,0.255,156,295,0.529,0.47,81,116,0.698,44,202,246,87,30,23,68,93,546
2018,Scott Machado\machasc01,PG,28,LAL,4,0,19,4,6,0.667,1,1,1,3,5,0.6,0.75,1,1,1,0,0,0,3,1,0,0,2,10
2018,Shelvin Mack\macksh01,PG,28,TOT,57,3,1246,163,403,0.404,46,130,0.354,117,273,0.429,0.462,58,84,0.69,18,86,104,183,47,4,66,84,430
2018,Shelvin Mack\macksh01,PG,28,MEM,53,3,1204,161,389,0.414,46,128,0.359,115,261,0.441,0.473,53,75,0.707,18,84,102,182,45,4,62,81,421
2018,Shelvin Mack\macksh01,PG,28,CHO,4,0,42,2,14,0.143,0,2,0,2,12,0.167,0.143,5,9,0.556,0,2,2,1,2,0,4,3,9
2018,Daryl Macon\maconda01,SG,23,DAL,8,0,90,10,27,0.37,5,11,0.455,5,16,0.313,0.463,4,7,0.571,2,10,12,7,1,0,6,8,29
2018,J.P. Macura\macurjp01,SG,23,CHO,2,0,17,3,9,0.333,0,4,0,3,5,0.6,0.333,0,0,,0,3,3,2,0,0,0,0,6
2018,Ian Mahinmi\mahinia01,C,32,WAS,34,6,498,47,104,0.452,3,16,0.188,44,88,0.5,0.466,42,61,0.689,48,80,128,25,25,16,21,84,139
2018,Thon Maker\makerth01,C-PF,21,TOT,64,5,972,109,268,0.407,49,153,0.32,60,115,0.522,0.498,56,84,0.667,41,161,202,45,21,51,33,105,323
2018,Thon Maker\makerth01,C,21,MIL,35,0,409,59,134,0.44,26,78,0.333,33,56,0.589,0.537,20,37,0.541,17,79,96,18,10,18,9,55,164
2018,Thon Maker\makerth01,PF,21,DET,29,5,563,50,134,0.373,23,75,0.307,27,59,0.458,0.459,36,47,0.766,24,82,106,27,11,33,24,50,159
2018,Boban Marjanović\marjabo01,C,30,TOT,58,12,681,160,260,0.615,4,10,0.4,156,250,0.624,0.623,98,131,0.748,87,178,265,54,16,27,59,90,422
2018,Boban Marjanović\marjabo01,C,30,LAC,36,9,376,85,140,0.607,0,2,0,85,138,0.616,0.607,72,95,0.758,55,97,152,22,11,17,37,57,242
2018,Boban Marjanović\marjabo01,C,30,PHI,22,3,305,75,120,0.625,4,8,0.5,71,112,0.634,0.642,26,36,0.722,32,81,113,32,5,10,22,33,180
2018,Lauri Markkanen\markkla01,PF,21,CHI,52,51,1682,342,795,0.43,120,332,0.361,222,463,0.479,0.506,170,195,0.872,74,396,470,75,37,33,85,122,974
2018,Jarell Martin\martija01,PF,24,ORL,42,1,328,43,104,0.413,20,57,0.351,23,47,0.489,0.51,9,11,0.818,11,62,73,18,3,8,11,51,115
2018,Frank Mason\masonfr01,PG,24,SAC,38,0,435,71,169,0.42,14,64,0.219,57,105,0.543,0.462,39,57,0.684,6,37,43,84,16,4,36,34,195
2018,Yante Maten\matenya01,PF,22,MIA,2,0,13,1,4,0.25,0,1,0,1,3,0.333,0.25,0,0,,1,2,3,0,1,0,0,0,2
2018,Wesley Matthews\matthwe02,SF-SG,32,TOT,69,68,2091,279,698,0.4,150,403,0.372,129,295,0.437,0.507,132,163,0.81,32,138,170,160,54,17,91,160,840
2018,Wesley Matthews\matthwe02,SF,32,DAL,44,44,1312,194,469,0.414,100,263,0.38,94,206,0.456,0.52,87,110,0.791,20,82,102,100,33,12,58,102,575
2018,Wesley Matthews\matthwe02,SG,32,NYK,2,1,54,4,19,0.211,2,10,0.2,2,9,0.222,0.263,4,5,0.8,1,2,3,5,1,1,2,2,14
2018,Wesley Matthews\matthwe02,SG,32,IND,23,23,725,81,210,0.386,48,130,0.369,33,80,0.413,0.5,41,48,0.854,11,54,65,55,20,4,31,56,251
2018,Luc Mbah a Moute\mbahalu01,PF,32,LAC,4,0,61,8,18,0.444,2,6,0.333,6,12,0.5,0.5,2,5,0.4,2,5,7,2,1,1,2,8,20
2018,Tahjere McCall\mccalta01,SG,24,BRK,1,0,8,2,3,0.667,0,1,0,2,2,1,0.667,0,1,0,0,1,1,0,0,0,0,2,4
2018,Patrick McCaw\mccawpa01,SG,23,TOT,29,1,397,26,63,0.413,9,28,0.321,17,35,0.486,0.484,13,15,0.867,7,41,48,29,23,2,17,38,74
2018,Patrick McCaw\mccawpa01,SG,23,CLE,3,0,53,2,9,0.222,1,4,0.25,1,5,0.2,0.278,0,0,,0,3,3,2,2,0,3,1,5
2018,Patrick McCaw\mccawpa01,SG,23,TOR,26,1,344,24,54,0.444,8,24,0.333,16,30,0.533,0.519,13,15,0.867,7,38,45,27,21,2,14,37,69
2018,CJ McCollum\mccolcj01,SG,27,POR,70,70,2375,571,1243,0.459,167,445,0.375,404,798,0.506,0.527,159,192,0.828,62,220,282,207,55,28,106,172,1468
2018,T.J. McConnell\mccontj01,PG,26,PHI,76,3,1470,220,419,0.525,14,42,0.333,206,377,0.546,0.542,29,37,0.784,28,146,174,258,79,17,91,105,483
2018,Doug McDermott\mcderdo01,SF,27,IND,77,1,1340,207,422,0.491,84,206,0.408,123,216,0.569,0.59,66,79,0.835,17,92,109,67,18,8,42,104,564
2018,JaVale McGee\mcgeeja01,C,31,LAL,75,62,1671,400,641,0.624,1,12,0.083,399,629,0.634,0.625,96,152,0.632,195,371,566,52,47,148,108,208,897
2018,Rodney McGruder\mcgruro01,SG,27,MIA,66,45,1550,186,461,0.403,79,225,0.351,107,236,0.453,0.489,52,72,0.722,60,178,238,112,36,12,64,115,503
2018,Alfonzo McKinnie\mckinal01,SF,26,GSW,72,5,1003,134,275,0.487,42,118,0.356,92,157,0.586,0.564,27,48,0.563,81,166,247,31,18,15,30,134,337
2018,Ben McLemore\mclembe01,SG,25,SAC,19,0,158,25,64,0.391,17,41,0.415,8,23,0.348,0.523,8,12,0.667,3,14,17,4,6,3,5,22,75
2018,Jordan McRae\mcraejo01,SG,27,WAS,27,0,333,61,130,0.469,10,35,0.286,51,95,0.537,0.508,28,35,0.8,6,34,40,30,13,7,15,26,160
2018,Jodie Meeks\meeksjo01,SG,31,TOR,8,0,104,21,39,0.538,8,18,0.444,13,21,0.619,0.641,1,1,1,1,11,12,8,1,1,2,5,51
2018,Salah Mejri\mejrisa01,C,32,DAL,36,4,399,55,112,0.491,11,34,0.324,44,78,0.564,0.54,20,32,0.625,36,95,131,35,10,26,21,55,141
2018,De'Anthony Melton\meltode01,PG,20,PHO,50,31,984,100,256,0.391,29,95,0.305,71,161,0.441,0.447,21,28,0.75,25,109,134,159,68,23,75,113,250
2018,Chimezie Metu\metuch01,PF,21,SAS,29,0,145,19,58,0.328,0,2,0,19,56,0.339,0.328,13,17,0.765,9,27,36,13,6,2,15,14,51
2018,Khris Middleton\middlkh01,SF,27,MIL,77,77,2393,506,1148,0.441,179,474,0.378,327,674,0.485,0.519,216,258,0.837,50,411,461,331,80,7,174,172,1407
2018,C.J. Miles\milescj01,SF,31,TOT,53,1,856,112,311,0.36,67,203,0.33,45,108,0.417,0.468,48,58,0.828,13,82,95,36,26,15,30,79,339
2018,C.J. Miles\milescj01,SF,31,TOR,40,1,562,70,206,0.34,43,137,0.314,27,69,0.391,0.444,35,44,0.795,12,56,68,22,18,10,21,62,218
2018,C.J. Miles\milescj01,SF,31,MEM,13,0,294,42,105,0.4,24,66,0.364,18,39,0.462,0.514,13,14,0.929,1,26,27,14,8,5,9,17,121
2018,Darius Miller\milleda01,SF,28,NOP,69,15,1757,189,484,0.39,133,364,0.365,56,120,0.467,0.528,56,71,0.789,14,114,128,146,40,23,59,165,567
2018,Malcolm Miller\millema01,SF,25,TOR,10,0,67,11,26,0.423,10,21,0.476,1,5,0.2,0.615,3,4,0.75,1,4,5,1,1,1,1,5,35
2018,Patty Mills\millspa02,PG,30,SAS,82,1,1908,282,663,0.425,159,404,0.394,123,259,0.475,0.545,88,103,0.854,24,158,182,245,49,10,93,129,811
2018,Paul Millsap\millspa01,PF,33,DEN,70,65,1895,322,665,0.484,58,159,0.365,264,506,0.522,0.528,181,249,0.727,153,352,505,141,83,54,95,183,883
2018,Shake Milton\miltosh01,SG,22,PHI,20,0,268,34,87,0.391,14,44,0.318,20,43,0.465,0.471,5,7,0.714,9,26,35,18,8,8,6,29,87
2018,Nikola Mirotić\mirotni01,PF,27,TOT,46,25,1245,238,542,0.439,116,318,0.365,122,224,0.545,0.546,105,124,0.847,60,279,339,55,31,34,48,107,697
2018,Nikola Mirotić\mirotni01,PF,27,NOP,32,22,925,182,407,0.447,85,231,0.368,97,176,0.551,0.552,85,101,0.842,46,218,264,35,21,25,37,86,534
2018,Nikola Mirotić\mirotni01,PF,27,MIL,14,3,320,56,135,0.415,31,87,0.356,25,48,0.521,0.53,20,23,0.87,14,61,75,20,10,9,11,21,163
2018,Donovan Mitchell\mitchdo01,SG,22,UTA,77,77,2598,661,1530,0.432,188,519,0.362,473,1011,0.468,0.493,319,396,0.806,59,257,316,322,106,31,218,208,1829
2018,Naz Mitrou-Long\mitrona01,SG,25,UTA,14,0,84,6,20,0.3,2,11,0.182,4,9,0.444,0.35,2,2,1,1,5,6,15,1,1,8,10,16
2018,Malik Monk\monkma01,SG,20,CHO,73,0,1258,227,586,0.387,109,330,0.33,118,256,0.461,0.48,90,102,0.882,16,121,137,117,37,19,86,106,653
2018,Greg Monroe\monrogr01,C,28,TOT,43,2,480,92,189,0.487,1,5,0.2,91,184,0.495,0.489,45,72,0.625,67,105,172,24,14,8,32,66,230
2018,Greg Monroe\monrogr01,C,28,TOR,38,2,423,74,161,0.46,0,4,0,74,157,0.471,0.46,35,61,0.574,60,96,156,16,13,8,31,61,183
2018,Greg Monroe\monrogr01,C,28,BOS,2,0,5,3,5,0.6,0,0,,3,5,0.6,0.6,0,0,,3,0,3,1,0,0,0,0,6
2018,Greg Monroe\monrogr01,C,28,PHI,3,0,52,15,23,0.652,1,1,1,14,22,0.636,0.674,10,11,0.909,4,9,13,7,1,0,1,5,41
2018,E'Twaun Moore\mooreet01,SG,29,NOP,53,36,1463,256,532,0.481,76,176,0.432,180,356,0.506,0.553,45,59,0.763,35,92,127,102,40,8,59,112,633
2018,Eric Moreland\moreler01,PF,27,TOT,5,0,43,3,7,0.429,1,1,1,2,6,0.333,0.5,0,0,,4,16,20,4,1,1,5,9,7
2018,Eric Moreland\moreler01,PF,27,PHO,1,0,5,0,0,,0,0,,0,0,,,0,0,,0,3,3,0,0,0,0,1,0
2018,Eric Moreland\moreler01,PF,27,TOR,4,0,38,3,7,0.429,1,1,1,2,6,0.333,0.5,0,0,,4,13,17,4,1,1,5,8,7
2018,Jaylen Morris\morrija01,SG,23,MIL,4,0,29,4,10,0.4,1,3,0.333,3,7,0.429,0.45,1,2,0.5,0,5,5,4,2,0,1,1,10
2018,Marcus Morris\morrima03,PF,29,BOS,75,53,2091,377,844,0.447,146,389,0.375,231,455,0.508,0.533,146,173,0.844,76,382,458,109,43,25,92,181,1046
2018,Markieff Morris\morrima02,PF,29,TOT,58,16,1270,204,484,0.421,68,203,0.335,136,281,0.484,0.492,71,92,0.772,61,204,265,79,36,22,54,175,547
2018,Markieff Morris\morrima02,PF,29,WAS,34,15,883,143,328,0.436,48,144,0.333,95,184,0.516,0.509,57,73,0.781,41,133,174,60,25,20,47,117,391
2018,Markieff Morris\morrima02,PF,29,OKC,24,1,387,61,156,0.391,20,59,0.339,41,97,0.423,0.455,14,19,0.737,20,71,91,19,11,2,7,58,156
2018,Monte Morris\morrimo01,PG,23,DEN,82,6,1970,346,702,0.493,94,227,0.414,252,475,0.531,0.56,65,81,0.802,35,159,194,297,73,4,52,102,851
2018,Donatas Motiejūnas\motiedo01,PF,28,SAS,3,0,13,3,6,0.5,0,0,,3,6,0.5,0.5,0,2,0,2,1,3,1,0,1,3,6,6
2018,Johnathan Motley\motlejo01,PF,23,LAC,22,0,156,39,73,0.534,0,3,0,39,70,0.557,0.534,24,40,0.6,18,33,51,11,5,3,16,27,102
2018,Emmanuel Mudiay\mudiaem01,PG,22,NYK,59,42,1607,330,740,0.446,69,210,0.329,261,530,0.492,0.493,144,186,0.774,33,163,196,228,43,19,140,103,873
2018,Jamal Murray\murraja01,PG,21,DEN,75,74,2447,513,1173,0.437,152,414,0.367,361,759,0.476,0.502,189,223,0.848,65,252,317,363,67,27,158,153,1367
2018,Džanan Musa\musadz01,SG,19,BRK,9,0,39,9,22,0.409,1,10,0.1,8,12,0.667,0.432,0,2,0,1,4,5,2,2,0,4,1,19
2018,Mike Muscala\muscami01,PF,27,TOT,64,10,1306,145,361,0.402,89,256,0.348,56,105,0.533,0.525,70,85,0.824,57,187,244,76,22,38,48,130,449
2018,Mike Muscala\muscami01,PF,27,PHI,47,6,1041,109,278,0.392,68,199,0.342,41,79,0.519,0.514,63,77,0.818,51,149,200,62,18,27,43,112,349
2018,Mike Muscala\muscami01,PF,27,LAL,17,4,265,36,83,0.434,21,57,0.368,15,26,0.577,0.56,7,8,0.875,6,38,44,14,4,11,5,18,100
2018,Sviatoslav Mykhailiuk\mykhasv01,SF,21,TOT,42,0,440,46,140,0.329,29,89,0.326,17,51,0.333,0.432,12,20,0.6,9,27,36,37,14,1,21,25,133
2018,Sviatoslav Mykhailiuk\mykhasv01,SF,21,LAL,39,0,420,44,132,0.333,27,85,0.318,17,47,0.362,0.436,12,20,0.6,8,26,34,33,13,1,20,25,127
2018,Sviatoslav Mykhailiuk\mykhasv01,SF,21,DET,3,0,20,2,8,0.25,2,4,0.5,0,4,0,0.375,0,0,,1,1,2,4,1,0,1,0,6
2018,Abdel Nader\naderab01,SF,25,OKC,61,1,694,91,215,0.423,32,100,0.32,59,115,0.513,0.498,27,36,0.75,14,102,116,20,20,12,26,68,241
2018,Larry Nance\nancela02,C,26,CLE,67,30,1795,249,479,0.52,33,98,0.337,216,381,0.567,0.554,96,134,0.716,168,384,552,214,100,40,97,192,627
2018,Shabazz Napier\napiesh01,PG,27,BRK,56,2,983,169,435,0.389,76,228,0.333,93,207,0.449,0.476,115,138,0.833,18,82,100,143,41,16,66,67,529
2018,Raul Neto\netora01,PG,26,UTA,37,1,474,74,161,0.46,20,60,0.333,54,101,0.535,0.522,28,33,0.848,6,56,62,93,14,4,35,49,196
2018,Georges Niang\niangge01,PF,25,UTA,59,0,516,86,181,0.475,43,105,0.41,43,76,0.566,0.594,20,24,0.833,11,76,87,35,10,6,23,57,235
2018,Joakim Noah\noahjo01,C,33,MEM,42,1,693,110,213,0.516,0,1,0,110,212,0.519,0.516,78,109,0.716,58,180,238,89,20,31,50,96,298
2018,Nerlens Noel\noelne01,C,24,OKC,77,2,1055,162,276,0.587,0,0,,162,276,0.587,0.587,54,79,0.684,127,198,325,45,66,96,48,166,378
2018,Dirk Nowitzki\nowitdi01,PF,40,DAL,51,20,795,135,376,0.359,64,205,0.312,71,171,0.415,0.444,39,50,0.78,5,153,158,35,9,18,18,76,373
2018,Frank Ntilikina\ntilila01,PG,20,NYK,43,16,904,95,282,0.337,33,115,0.287,62,167,0.371,0.395,23,30,0.767,12,75,87,121,30,14,56,104,246
2018,James Nunnally\nunnaja01,SF,28,TOT,15,0,102,12,34,0.353,8,25,0.32,4,9,0.444,0.471,4,4,1,0,5,5,7,1,0,1,10,36
2018,James Nunnally\nunnaja01,SF,28,MIN,13,0,64,9,21,0.429,5,13,0.385,4,8,0.5,0.548,4,4,1,0,4,4,5,1,0,1,4,27
2018,James Nunnally\nunnaja01,SF,28,HOU,2,0,38,3,13,0.231,3,12,0.25,0,1,0,0.346,0,0,,0,1,1,2,0,0,0,6,9
2018,Jusuf Nurkić\nurkiju01,C,24,POR,72,72,1974,420,826,0.508,3,29,0.103,417,797,0.523,0.51,282,365,0.773,243,505,748,233,71,103,168,250,1125
2018,David Nwaba\nwabada01,SG,26,CLE,51,14,984,126,262,0.481,24,75,0.32,102,187,0.545,0.527,58,85,0.682,41,122,163,54,36,17,29,106,334
2018,Royce O'Neale\onealro01,SF,25,UTA,82,16,1671,163,343,0.475,68,176,0.386,95,167,0.569,0.574,32,42,0.762,22,263,285,124,54,24,70,172,426
2018,Kyle O'Quinn\oquinky01,C,28,IND,45,3,371,69,136,0.507,1,12,0.083,68,124,0.548,0.511,17,21,0.81,29,90,119,56,9,25,31,68,156
2018,Semi Ojeleye\ojelese01,PF,24,BOS,56,3,594,67,158,0.424,28,89,0.315,39,69,0.565,0.513,24,39,0.615,24,62,86,23,10,4,19,43,186
2018,Jahlil Okafor\okafoja01,C,23,NOP,59,24,935,212,362,0.586,1,5,0.2,211,357,0.591,0.587,59,89,0.663,82,196,278,40,15,40,52,96,484
2018,Elie Okobo\okoboel01,PG,21,PHO,53,16,958,114,290,0.393,39,132,0.295,75,158,0.475,0.46,37,47,0.787,12,86,98,127,32,7,69,109,304
2018,Josh Okogie\okogijo01,SG,20,MIN,74,52,1757,196,508,0.386,60,215,0.279,136,293,0.464,0.445,118,162,0.728,41,177,218,91,88,33,63,166,570
2018,Victor Oladipo\oladivi01,SG,26,IND,36,36,1147,249,588,0.423,74,216,0.343,175,372,0.47,0.486,103,141,0.73,21,181,202,186,60,11,82,72,675
2018,Kelly Olynyk\olynyke01,PF,27,MIA,79,36,1812,261,564,0.463,113,319,0.354,148,245,0.604,0.563,152,185,0.822,72,303,375,140,53,37,114,183,787
2018,Cedi Osman\osmande01,SF,23,CLE,76,75,2444,360,844,0.427,130,374,0.348,230,470,0.489,0.504,141,181,0.779,45,312,357,195,60,11,114,195,991
2018,Kelly Oubre\oubreke01,SF,23,TOT,69,19,1935,375,842,0.445,108,338,0.32,267,504,0.53,0.51,189,244,0.775,71,254,325,84,84,59,103,181,1047
2018,Kelly Oubre\oubreke01,SF,23,WAS,29,7,755,132,305,0.433,41,132,0.311,91,173,0.526,0.5,68,85,0.8,24,105,129,20,27,20,30,71,373
2018,Kelly Oubre\oubreke01,SF,23,PHO,40,12,1180,243,537,0.453,67,206,0.325,176,331,0.532,0.515,121,159,0.761,47,149,196,64,57,39,73,110,674
2018,Zaza Pachulia\pachuza01,C,34,DET,68,3,878,85,193,0.44,0,4,0,85,189,0.45,0.44,97,124,0.782,99,166,265,91,31,17,57,151,267
2018,Jabari Parker\parkeja01,PF,23,TOT,64,17,1724,369,749,0.493,61,195,0.313,308,554,0.556,0.533,131,184,0.712,79,342,421,152,46,30,151,145,930
2018,Jabari Parker\parkeja01,PF,23,CHI,39,17,1042,220,464,0.474,37,114,0.325,183,350,0.523,0.514,79,108,0.731,41,200,241,84,23,14,84,87,556
2018,Jabari Parker\parkeja01,PF,23,WAS,25,0,682,149,285,0.523,24,81,0.296,125,204,0.613,0.565,52,76,0.684,38,142,180,68,23,16,67,58,374
2018,Tony Parker\parketo01,PG,36,CHO,56,0,1003,213,463,0.46,13,51,0.255,200,412,0.485,0.474,91,124,0.734,14,69,83,207,21,7,75,53,530
2018,Chandler Parsons\parsoch01,SF,30,MEM,25,3,496,68,182,0.374,29,94,0.309,39,88,0.443,0.453,22,25,0.88,4,66,70,43,19,5,32,45,187
2018,Patrick Patterson\pattepa01,PF,29,OKC,63,5,861,82,219,0.374,46,137,0.336,36,82,0.439,0.479,19,30,0.633,42,105,147,31,16,13,22,46,229
2018,Justin Patton\pattoju01,C,21,PHI,3,0,21,2,7,0.286,0,2,0,2,5,0.4,0.286,1,2,0.5,2,4,6,3,2,0,0,5,5
2018,Chris Paul\paulch01,PG,33,HOU,58,58,1857,302,720,0.419,127,355,0.358,175,365,0.479,0.508,175,203,0.862,36,229,265,473,114,18,152,146,906
2018,Cameron Payne\payneca01,PG,24,TOT,40,13,712,96,223,0.43,25,84,0.298,71,139,0.511,0.487,33,41,0.805,13,59,72,106,28,9,45,64,250
2018,Cameron Payne\payneca01,PG,24,CHI,31,12,536,69,168,0.411,16,59,0.271,53,109,0.486,0.458,22,25,0.88,10,43,53,83,20,6,34,49,176
2018,Cameron Payne\payneca01,PG,24,CLE,9,1,176,27,55,0.491,9,25,0.36,18,30,0.6,0.573,11,16,0.688,3,16,19,23,8,3,11,15,74
2018,Elfrid Payton\paytoel01,PG,24,NOP,42,42,1250,179,412,0.434,33,105,0.314,146,307,0.476,0.475,55,74,0.743,49,171,220,320,44,17,112,81,446
2018,Gary Payton\paytoga02,PG,26,WAS,3,0,16,5,8,0.625,1,2,0.5,4,6,0.667,0.688,0,0,,1,1,2,4,3,1,1,2,11
2018,Theo Pinson\pinsoth01,SG,23,BRK,18,0,211,25,73,0.342,12,46,0.261,13,27,0.481,0.425,19,22,0.864,4,32,36,21,6,0,18,15,81
2018,Mason Plumlee\plumlma01,C,28,DEN,82,17,1731,262,442,0.593,2,10,0.2,260,432,0.602,0.595,111,198,0.561,165,359,524,243,66,76,126,252,637
2018,Miles Plumlee\plumlmi01,C,30,ATL,18,0,173,32,48,0.667,0,0,,32,48,0.667,0.667,16,30,0.533,16,23,39,17,6,4,10,14,80
2018,Jakob Pöltl\poeltja01,C,23,SAS,77,24,1273,187,290,0.645,0,0,,187,290,0.645,0.645,49,92,0.533,178,232,410,93,29,68,48,124,423
2018,Quincy Pondexter\pondequ01,SF,30,SAS,53,0,292,29,58,0.5,6,18,0.333,23,40,0.575,0.552,34,42,0.81,8,38,46,24,11,1,13,24,98
2018,Otto Porter\porteot01,SF,25,TOT,56,43,1683,299,643,0.465,104,256,0.406,195,387,0.504,0.546,78,96,0.813,54,260,314,120,82,31,65,108,780
2018,Otto Porter\porteot01,SF,25,WAS,41,28,1191,202,442,0.457,65,176,0.369,137,266,0.515,0.531,49,64,0.766,40,191,231,80,64,22,40,79,518
2018,Otto Porter\porteot01,SF,25,CHI,15,15,492,97,201,0.483,39,80,0.488,58,121,0.479,0.58,29,32,0.906,14,69,83,40,18,9,25,29,262
2018,Bobby Portis\portibo01,PF,23,TOT,50,28,1299,279,628,0.444,75,191,0.393,204,437,0.467,0.504,77,97,0.794,109,294,403,72,35,20,74,145,710
2018,Bobby Portis\portibo01,PF,23,CHI,22,6,531,122,271,0.45,27,72,0.375,95,199,0.477,0.5,39,50,0.78,46,115,161,29,11,8,29,61,310
2018,Bobby Portis\portibo01,PF,23,WAS,28,22,768,157,357,0.44,48,119,0.403,109,238,0.458,0.507,38,47,0.809,63,179,242,43,24,12,45,84,400
2018,Dwight Powell\poweldw01,C,27,DAL,77,22,1662,290,486,0.597,39,127,0.307,251,359,0.699,0.637,196,254,0.772,140,271,411,112,44,50,67,201,815
2018,Norman Powell\powelno01,SG,25,TOR,60,3,1126,193,400,0.483,68,170,0.4,125,230,0.543,0.568,62,75,0.827,16,123,139,91,39,13,65,96,516
2018,Alex Poythress\poythal01,PF,25,ATL,21,1,305,40,81,0.494,9,23,0.391,31,58,0.534,0.549,18,29,0.621,29,47,76,17,4,10,13,47,107
2018,Zhou Qi\qizh01,PF,23,HOU,1,0,1,1,1,1,0,0,,1,1,1,1,0,0,,0,0,0,0,0,0,0,0,2
2018,Ivan Rabb\rabbiv01,PF,21,MEM,49,13,721,116,212,0.547,3,15,0.2,113,197,0.574,0.554,49,69,0.71,70,136,206,54,17,14,35,90,284
2018,Chasson Randle\randlch01,PG,25,WAS,49,2,743,91,217,0.419,46,115,0.4,45,102,0.441,0.525,43,62,0.694,10,46,56,97,25,3,43,91,271
2018,Julius Randle\randlju01,PF,24,NOP,73,49,2232,571,1089,0.524,67,195,0.344,504,894,0.564,0.555,356,487,0.731,162,472,634,229,52,45,208,246,1565
2018,J.J. Redick\redicjj01,SG,34,PHI,76,63,2379,452,1027,0.44,240,605,0.397,212,422,0.502,0.557,228,255,0.894,20,166,186,206,32,17,101,129,1372
2018,Davon Reed\reedda01,SG,23,IND,10,0,47,5,12,0.417,2,4,0.5,3,8,0.375,0.5,0,0,,2,4,6,3,1,0,1,3,12
2018,Cameron Reynolds\reynoca01,SG,23,MIN,19,0,259,33,78,0.423,21,51,0.412,12,27,0.444,0.558,8,9,0.889,4,27,31,13,6,2,5,26,95
2018,Josh Richardson\richajo01,SG,25,MIA,73,73,2539,423,1026,0.412,164,460,0.357,259,566,0.458,0.492,199,231,0.861,54,209,263,298,79,34,113,200,1209
2018,Malachi Richardson\richama01,SG,23,TOR,22,0,103,9,29,0.31,8,25,0.32,1,4,0.25,0.448,4,5,0.8,2,11,13,0,1,0,8,13,30
2018,Austin Rivers\riverau01,SG,26,TOT,76,15,2028,232,572,0.406,104,327,0.318,128,245,0.522,0.497,50,95,0.526,25,137,162,167,47,23,68,207,618
2018,Austin Rivers\riverau01,SG,26,WAS,29,2,683,76,194,0.392,33,106,0.311,43,88,0.489,0.477,25,46,0.543,10,61,71,58,18,10,36,72,210
2018,Austin Rivers\riverau01,SG,26,HOU,47,13,1345,156,378,0.413,71,221,0.321,85,157,0.541,0.507,25,49,0.51,15,76,91,109,29,13,32,135,408
2018,Devin Robinson\robinde01,SF,23,WAS,7,0,95,19,32,0.594,0,2,0,19,30,0.633,0.594,9,14,0.643,6,14,20,6,4,6,2,11,47
2018,Duncan Robinson\robindu01,PF,24,MIA,15,1,161,18,46,0.391,10,35,0.286,8,11,0.727,0.5,4,6,0.667,2,17,19,5,5,0,4,11,50
2018,Glenn Robinson\robingl02,SF,25,DET,47,18,610,74,176,0.42,18,62,0.29,56,114,0.491,0.472,32,40,0.8,17,54,71,21,14,8,18,45,198
2018,Jerome Robinson\robinje01,SG,21,LAC,33,0,320,44,110,0.4,18,57,0.316,26,53,0.491,0.482,6,9,0.667,3,38,41,19,11,3,13,46,112
2018,Mitchell Robinson\robinmi01,C,20,NYK,66,19,1360,202,291,0.694,0,0,,202,291,0.694,0.694,81,135,0.6,177,246,423,37,52,161,35,217,485
2018,Rajon Rondo\rondora01,PG,32,LAL,46,29,1369,175,432,0.405,51,142,0.359,124,290,0.428,0.464,23,36,0.639,34,209,243,367,57,7,127,100,424
2018,Derrick Rose\rosede01,PG,30,MIN,51,13,1392,363,753,0.482,54,146,0.37,309,607,0.509,0.518,137,160,0.856,33,107,140,220,31,12,82,57,917
2018,Terrence Ross\rosste01,SG,27,ORL,81,0,2150,440,1027,0.428,217,566,0.383,223,461,0.484,0.534,126,144,0.875,27,253,280,135,72,29,90,119,1223
2018,Terry Rozier\roziete01,PG,24,BOS,79,14,1791,258,666,0.387,119,337,0.353,139,329,0.422,0.477,73,93,0.785,32,275,307,231,68,21,68,101,708
2018,Ricky Rubio\rubiori01,PG,28,UTA,68,67,1899,295,730,0.404,79,254,0.311,216,476,0.454,0.458,195,228,0.855,33,210,243,416,91,10,180,180,864
2018,D'Angelo Russell\russeda01,PG,22,BRK,81,81,2448,659,1517,0.434,234,635,0.369,425,882,0.482,0.512,160,205,0.78,53,262,315,563,100,20,253,141,1712
2018,Domantas Sabonis\sabondo01,C,22,IND,74,5,1838,413,700,0.59,9,17,0.529,404,683,0.592,0.596,208,291,0.715,186,504,690,212,48,30,160,239,1043
2018,Brandon Sampson\sampsbr01,SG,21,CHI,14,2,214,28,60,0.467,11,29,0.379,17,31,0.548,0.558,4,6,0.667,3,13,16,10,8,3,12,19,71
2018,JaKarr Sampson\sampsja02,SF,25,CHI,4,0,127,29,54,0.537,5,14,0.357,24,40,0.6,0.583,17,21,0.81,5,27,32,4,4,3,4,8,80
2018,Dario Šarić\saricda01,PF,24,TOT,81,41,2023,304,696,0.437,118,323,0.365,186,373,0.499,0.522,132,150,0.88,126,331,457,127,45,9,97,182,858
2018,Dario Šarić\saricda01,PF,24,PHI,13,13,396,48,132,0.364,21,70,0.3,27,62,0.435,0.443,27,30,0.9,21,65,86,26,4,3,25,39,144
2018,Dario Šarić\saricda01,PF,24,MIN,68,28,1627,256,564,0.454,97,253,0.383,159,311,0.511,0.54,105,120,0.875,105,266,371,101,41,6,72,143,714
2018,Tomáš Satoranský\satorto01,PG,27,WAS,80,54,2164,257,530,0.485,64,162,0.395,193,368,0.524,0.545,131,160,0.819,82,197,279,399,82,13,120,172,709
2018,Dennis Schröder\schrode01,PG,25,OKC,79,14,2314,457,1104,0.414,124,364,0.341,333,740,0.45,0.47,186,227,0.819,38,246,284,323,65,12,172,189,1224
2018,Mike Scott\scottmi01,PF,30,TOT,79,3,1395,168,420,0.4,101,252,0.401,67,168,0.399,0.52,22,33,0.667,43,233,276,66,26,13,44,156,459
2018,Mike Scott\scottmi01,PF,30,LAC,52,0,748,92,230,0.4,52,133,0.391,40,97,0.412,0.513,12,18,0.667,24,150,174,44,17,8,27,88,248
2018,Mike Scott\scottmi01,PF,30,PHI,27,3,647,76,190,0.4,49,119,0.412,27,71,0.38,0.529,10,15,0.667,19,83,102,22,9,5,17,68,211
2018,Thabo Sefolosha\sefolth01,SF,34,UTA,50,2,609,71,149,0.477,34,78,0.436,37,71,0.521,0.591,14,22,0.636,8,115,123,27,43,5,25,41,190
2018,Wayne Selden\seldewa01,SG,24,TOT,75,13,1439,196,483,0.406,55,174,0.316,141,309,0.456,0.463,67,92,0.728,37,143,180,109,33,13,79,131,514
2018,Wayne Selden\seldewa01,SG,24,MEM,32,0,455,65,161,0.404,20,63,0.317,45,98,0.459,0.466,22,29,0.759,16,28,44,36,10,6,23,48,172
2018,Wayne Selden\seldewa01,SG,24,CHI,43,13,984,131,322,0.407,35,111,0.315,96,211,0.455,0.461,45,63,0.714,21,115,136,73,23,7,56,83,342
2018,Collin Sexton\sextoco01,PG,20,CLE,82,72,2605,519,1206,0.43,119,296,0.402,400,910,0.44,0.48,214,255,0.839,57,179,236,243,44,6,185,186,1371
2018,Landry Shamet\shamela01,SG,21,TOT,79,27,1802,240,557,0.431,167,396,0.422,73,161,0.453,0.581,75,93,0.806,21,113,134,117,37,10,45,155,722
2018,Landry Shamet\shamela01,SG,21,PHI,54,4,1108,153,347,0.441,99,245,0.404,54,102,0.529,0.584,44,54,0.815,14,64,78,59,24,8,26,106,449
2018,Landry Shamet\shamela01,SG,21,LAC,25,23,694,87,210,0.414,68,151,0.45,19,59,0.322,0.576,31,39,0.795,7,49,56,58,13,2,19,49,273
2018,Iman Shumpert\shumpim01,SG,28,TOT,62,41,1481,167,446,0.374,95,273,0.348,72,173,0.416,0.481,36,45,0.8,27,156,183,112,59,24,50,127,465
2018,Iman Shumpert\shumpim01,SG,28,SAC,42,40,1099,133,348,0.382,74,202,0.366,59,146,0.404,0.489,34,41,0.829,19,110,129,91,47,20,38,92,374
2018,Iman Shumpert\shumpim01,SG,28,HOU,20,1,382,34,98,0.347,21,71,0.296,13,27,0.481,0.454,2,4,0.5,8,46,54,21,12,4,12,35,91
2018,Pascal Siakam\siakapa01,PF,24,TOR,80,79,2548,519,945,0.549,79,214,0.369,440,731,0.602,0.591,237,302,0.785,124,425,549,248,73,52,154,241,1354
2018,Jordan Sibert\siberjo01,SG,26,ATL,1,0,4,1,1,1,1,1,1,0,0,,1.5,0,0,,0,0,0,0,0,0,0,0,3
2018,Ben Simmons\simmobe01,PG,22,PHI,79,79,2700,540,960,0.563,0,6,0,540,954,0.566,0.563,257,428,0.6,172,525,697,610,112,61,274,209,1337
2018,Jonathon Simmons\simmojo02,SG-SF,29,TOT,56,9,1064,133,350,0.38,28,104,0.269,105,246,0.427,0.42,72,97,0.742,27,99,126,128,29,15,68,89,366
2018,Jonathon Simmons\simmojo02,SG,29,ORL,41,9,845,104,286,0.364,19,83,0.229,85,203,0.419,0.397,56,72,0.778,23,77,100,95,18,14,56,68,283
2018,Jonathon Simmons\simmojo02,SF,29,PHI,15,0,219,29,64,0.453,9,21,0.429,20,43,0.465,0.523,16,25,0.64,4,22,26,33,11,1,12,21,83
2018,Kobi Simmons\simmoko01,PG,21,CLE,1,0,2,0,0,,0,0,,0,0,,,0,0,,0,0,0,0,0,0,0,0,0
2018,Anfernee Simons\simonan01,SG,19,POR,20,1,141,28,63,0.444,10,29,0.345,18,34,0.529,0.524,9,16,0.563,3,10,13,13,1,0,11,9,75
2018,Marcus Smart\smartma01,SG,24,BOS,80,60,2200,239,567,0.422,126,346,0.364,113,221,0.511,0.533,104,129,0.806,57,177,234,321,143,28,123,201,708
2018,Dennis Smith\smithde03,PG,21,TOT,53,50,1508,278,650,0.428,67,208,0.322,211,442,0.477,0.479,99,156,0.635,32,123,155,252,67,20,154,129,722
2018,Dennis Smith\smithde03,PG,21,DAL,32,32,908,157,357,0.44,43,125,0.344,114,232,0.491,0.5,57,82,0.695,18,79,97,138,40,11,100,82,414
2018,Dennis Smith\smithde03,PG,21,NYK,21,18,600,121,293,0.413,24,83,0.289,97,210,0.462,0.454,42,74,0.568,14,44,58,114,27,9,54,47,308
2018,Ish Smith\smithis01,PG,30,DET,56,0,1251,205,489,0.419,44,135,0.326,161,354,0.455,0.464,47,62,0.758,23,122,145,203,28,11,61,109,501
2018,J.R. Smith\smithjr01,SG,33,CLE,11,4,222,27,79,0.342,12,39,0.308,15,40,0.375,0.418,8,10,0.8,0,18,18,21,11,3,11,19,74
2018,Jason Smith\smithja02,PF-C,32,TOT,20,1,190,21,59,0.356,9,26,0.346,12,33,0.364,0.432,14,16,0.875,16,36,52,14,3,7,13,30,65
2018,Jason Smith\smithja02,C,32,WAS,12,1,130,15,37,0.405,4,10,0.4,11,27,0.407,0.459,10,12,0.833,11,26,37,12,1,5,7,21,44
2018,Jason Smith\smithja02,PF,32,MIL,6,0,40,4,13,0.308,3,9,0.333,1,4,0.25,0.423,2,2,1,3,8,11,1,2,2,5,6,13
2018,Jason Smith\smithja02,C,32,NOP,2,0,20,2,9,0.222,2,7,0.286,0,2,0,0.333,2,2,1,2,2,4,1,0,0,1,3,8
2018,Zhaire Smith\smithzh01,SG,19,PHI,6,2,111,14,34,0.412,6,16,0.375,8,18,0.444,0.5,6,8,0.75,3,10,13,10,2,2,6,8,40
2018,Tony Snell\snellto01,SF,27,MIL,74,12,1304,163,361,0.452,81,204,0.397,82,157,0.522,0.564,37,42,0.881,29,128,157,68,26,18,23,90,444
2018,Ray Spalding\spaldra01,PF,21,TOT,14,3,148,25,47,0.532,0,3,0,25,44,0.568,0.532,4,12,0.333,15,33,48,5,9,8,9,23,54
2018,Ray Spalding\spaldra01,PF,21,DAL,1,0,1,0,0,,0,0,,0,0,,,0,0,,0,0,0,0,0,0,0,0,0
2018,Ray Spalding\spaldra01,PF,21,PHO,13,3,147,25,47,0.532,0,3,0,25,44,0.568,0.532,4,12,0.333,15,33,48,5,9,8,9,23,54
2018,Omari Spellman\spellom01,PF,21,ATL,46,11,805,98,244,0.402,44,128,0.344,54,116,0.466,0.492,32,45,0.711,72,122,194,47,26,25,31,67,272
2018,Nik Stauskas\stausni01,SG,25,TOT,68,0,1015,136,338,0.402,70,188,0.372,66,150,0.44,0.506,57,64,0.891,18,109,127,81,21,7,51,50,399
2018,Nik Stauskas\stausni01,SG,25,POR,44,0,673,96,229,0.419,43,125,0.344,53,104,0.51,0.513,32,36,0.889,10,70,80,62,14,4,40,31,267
2018,Nik Stauskas\stausni01,SG,25,CLE,24,0,342,40,109,0.367,27,63,0.429,13,46,0.283,0.491,25,28,0.893,8,39,47,19,7,3,11,19,132
2018,D.J. Stephens\stephdj01,SG,28,MEM,1,0,7,1,2,0.5,0,0,,1,2,0.5,0.5,0,0,,0,0,0,0,1,0,1,0,2
2018,Lance Stephenson\stephla01,SG,28,LAL,68,3,1123,184,432,0.426,73,197,0.371,111,235,0.472,0.51,50,73,0.685,32,183,215,140,41,7,86,111,491
2018,Edmond Sumner\sumneed01,PG,23,IND,23,2,210,22,64,0.344,7,27,0.259,15,37,0.405,0.398,15,24,0.625,9,15,24,10,12,5,10,26,66
2018,Caleb Swanigan\swanica01,PF,21,TOT,21,0,178,18,53,0.34,1,7,0.143,17,46,0.37,0.349,6,9,0.667,17,47,64,11,6,1,18,28,43
2018,Caleb Swanigan\swanica01,PF,21,POR,18,0,145,14,44,0.318,1,5,0.2,13,39,0.333,0.33,6,7,0.857,13,39,52,7,4,0,16,22,35
2018,Caleb Swanigan\swanica01,PF,21,SAC,3,0,33,4,9,0.444,0,2,0,4,7,0.571,0.444,0,2,0,4,8,12,4,2,1,2,6,8
2018,Jayson Tatum\tatumja01,SF,20,BOS,79,79,2455,466,1036,0.45,116,311,0.373,350,725,0.483,0.506,195,228,0.855,70,407,477,168,84,57,122,168,1243
2018,Jeff Teague\teaguje01,PG,30,MIN,42,41,1264,176,416,0.423,35,105,0.333,141,311,0.453,0.465,123,153,0.804,16,90,106,343,43,18,97,90,510
2018,Garrett Temple\templga01,SG,32,TOT,75,55,2040,208,493,0.422,90,264,0.341,118,229,0.515,0.513,80,107,0.748,28,188,216,106,76,30,70,204,586
2018,Garrett Temple\templga01,SG,32,MEM,49,49,1530,166,387,0.429,74,210,0.352,92,177,0.52,0.525,57,76,0.75,18,134,152,69,50,25,54,134,463
2018,Garrett Temple\templga01,SG,32,LAC,26,6,510,42,106,0.396,16,54,0.296,26,52,0.5,0.472,23,31,0.742,10,54,64,37,26,5,16,70,123
2018,Miloš Teodosić\teodomi01,PG,31,LAC,15,0,150,17,40,0.425,10,27,0.37,7,13,0.538,0.55,4,7,0.571,3,13,16,32,3,1,21,27,48
2018,Jared Terrell\terreja01,SG,23,MIN,14,0,111,12,39,0.308,4,17,0.235,8,22,0.364,0.359,3,6,0.5,1,5,6,12,3,2,10,16,31
2018,Emanuel Terry\terryem01,PF,22,TOT,3,0,23,4,7,0.571,0,0,,4,7,0.571,0.571,2,4,0.5,3,4,7,2,3,0,2,4,10
2018,Emanuel Terry\terryem01,PF,22,PHO,2,0,20,4,6,0.667,0,0,,4,6,0.667,0.667,1,2,0.5,2,4,6,1,3,0,2,4,9
2018,Emanuel Terry\terryem01,PF,22,MIA,1,0,3,0,1,0,0,0,,0,1,0,0,1,2,0.5,1,0,1,1,0,0,0,0,1
2018,Daniel Theis\theisda01,C,26,BOS,66,2,908,146,266,0.549,26,67,0.388,120,199,0.603,0.598,56,76,0.737,87,138,225,68,21,42,33,161,374
2018,Isaiah Thomas\thomais02,SG,29,DEN,12,0,181,34,99,0.343,12,43,0.279,22,56,0.393,0.404,17,27,0.63,5,8,13,23,5,1,18,17,97
2018,Khyri Thomas\thomakh01,SG,22,DET,26,0,195,22,69,0.319,10,35,0.286,12,34,0.353,0.391,7,11,0.636,4,16,20,8,7,5,4,22,61
2018,Lance Thomas\thomala01,PF,30,NYK,46,17,783,78,197,0.396,22,79,0.278,56,118,0.475,0.452,27,36,0.75,21,96,117,27,17,7,24,83,205
2018,Klay Thompson\thompkl01,SG,28,GSW,78,78,2652,655,1402,0.467,241,599,0.402,414,803,0.516,0.553,129,158,0.816,37,262,299,186,84,47,115,157,1680
2018,Tristan Thompson\thomptr01,C,27,CLE,43,40,1198,201,380,0.529,0,0,,201,380,0.529,0.529,68,106,0.642,173,265,438,86,28,16,59,89,470
2018,Sindarius Thornwell\thornsi01,SG,24,LAC,64,1,313,17,49,0.347,3,15,0.2,14,34,0.412,0.378,25,34,0.735,5,39,44,18,14,7,20,41,62
2018,Anthony Tolliver\tollian01,PF,33,MIN,65,0,1079,99,259,0.382,81,215,0.377,18,44,0.409,0.539,47,60,0.783,15,162,177,46,17,21,36,91,326
2018,Karl-Anthony Towns\townska01,C,23,MIN,77,77,2545,681,1314,0.518,142,355,0.4,539,959,0.562,0.572,376,450,0.836,263,691,954,259,67,125,240,292,1880
2018,Gary Trent\trentga02,SG,20,POR,15,1,111,16,50,0.32,5,21,0.238,11,29,0.379,0.37,3,7,0.429,1,10,11,5,1,2,4,4,40
2018,Allonzo Trier\trieral01,SG,23,NYK,64,3,1459,232,518,0.448,52,132,0.394,180,386,0.466,0.498,179,223,0.803,31,166,197,119,28,14,116,117,695
2018,P.J. Tucker\tuckepj01,PF,33,HOU,82,82,2802,207,523,0.396,146,387,0.377,61,136,0.449,0.535,41,59,0.695,121,358,479,96,132,39,63,252,601
2018,Evan Turner\turneev01,PG,30,POR,73,2,1605,204,443,0.46,11,52,0.212,193,391,0.494,0.473,75,106,0.708,37,291,328,283,33,18,114,110,494
2018,Myles Turner\turnemy01,C,22,IND,74,74,2119,380,780,0.487,76,196,0.388,304,584,0.521,0.536,148,201,0.736,101,430,531,115,60,199,100,195,984
2018,Ekpe Udoh\udohek01,C,31,UTA,51,1,320,50,72,0.694,0,0,,50,72,0.694,0.694,19,30,0.633,27,63,90,28,10,31,13,36,119
2018,Tyler Ulis\ulisty01,PG,23,CHI,1,0,1,0,0,,0,0,,0,0,,,0,0,,0,0,0,0,0,0,0,0,0
2018,Jonas Valančiūnas\valanjo01,C,26,TOT,49,27,1091,301,538,0.559,14,48,0.292,287,490,0.586,0.572,147,185,0.795,106,313,419,70,19,53,90,146,763
2018,Jonas Valančiūnas\valanjo01,C,26,TOR,30,10,564,149,259,0.575,9,30,0.3,140,229,0.611,0.593,77,94,0.819,54,162,216,29,13,23,39,82,384
2018,Jonas Valančiūnas\valanjo01,C,26,MEM,19,17,527,152,279,0.545,5,18,0.278,147,261,0.563,0.554,70,91,0.769,52,151,203,41,6,30,51,64,379
2018,Jarred Vanderbilt\vandeja01,PF,19,DEN,17,0,69,9,19,0.474,0,1,0,9,18,0.5,0.474,6,10,0.6,7,16,23,3,6,1,8,8,24
2018,Fred VanVleet\vanvlfr01,PG,24,TOR,64,28,1760,246,600,0.41,112,296,0.378,134,304,0.441,0.503,97,115,0.843,21,146,167,307,57,20,82,110,701
2018,Noah Vonleh\vonleno01,PF,23,NYK,68,57,1722,207,440,0.47,46,137,0.336,161,303,0.531,0.523,111,156,0.712,113,415,528,129,46,51,88,174,571
2018,Nikola Vučević\vucevni01,C,28,ORL,80,80,2510,701,1354,0.518,84,231,0.364,617,1123,0.549,0.549,179,227,0.789,224,736,960,307,81,89,159,157,1665
2018,Dwyane Wade\wadedw01,SG,37,MIA,72,2,1885,416,960,0.433,86,261,0.33,330,699,0.472,0.478,165,233,0.708,69,216,285,301,59,38,166,118,1083
2018,Moritz Wagner\wagnemo01,C,21,LAL,43,5,446,71,171,0.415,22,77,0.286,49,94,0.521,0.48,43,53,0.811,17,68,85,24,11,13,39,57,207
2018,Dion Waiters\waitedi01,SG,27,MIA,44,28,1138,198,478,0.414,109,289,0.377,89,189,0.471,0.528,22,44,0.5,7,109,116,121,29,9,64,72,527
2018,Kemba Walker\walkeke02,PG,28,CHO,82,82,2863,731,1684,0.434,260,731,0.356,471,953,0.494,0.511,380,450,0.844,52,309,361,484,102,34,211,131,2102
2018,Lonnie Walker\walkelo01,SG,20,SAS,17,0,118,16,46,0.348,5,13,0.385,11,33,0.333,0.402,8,10,0.8,0,17,17,9,7,3,4,7,45
2018,John Wall\walljo01,PG,28,WAS,32,32,1104,245,552,0.444,51,169,0.302,194,383,0.507,0.49,122,175,0.697,15,101,116,279,49,29,121,71,663
2018,Tyrone Wallace\wallaty01,PG,24,LAC,62,0,628,92,217,0.424,4,19,0.211,88,198,0.444,0.433,30,57,0.526,20,81,101,42,21,7,36,83,218
2018,Taurean Waller-Prince\princta02,SF,24,ATL,55,47,1552,262,594,0.441,123,315,0.39,139,279,0.498,0.545,95,116,0.819,22,177,199,118,53,19,100,141,742
2018,Brad Wanamaker\wanambr01,PG,29,BOS,36,0,343,50,105,0.476,16,39,0.41,34,66,0.515,0.552,24,28,0.857,3,38,41,56,12,2,19,34,140
2018,T.J. Warren\warretj01,SF,25,PHO,43,36,1360,297,611,0.486,77,180,0.428,220,431,0.51,0.549,101,124,0.815,31,143,174,64,51,29,52,119,772
2018,Julian Washburn\washbju01,SF,27,MEM,18,3,254,16,48,0.333,5,24,0.208,11,24,0.458,0.385,3,4,0.75,8,33,41,14,13,2,7,16,40
2018,Yuta Watanabe\watanyu01,SF,24,MEM,15,0,174,15,51,0.294,2,16,0.125,13,35,0.371,0.314,7,10,0.7,4,27,31,8,4,1,6,11,39
2018,Thomas Welsh\welshth01,C,22,DEN,11,0,36,7,13,0.538,3,7,0.429,4,6,0.667,0.654,1,2,0.5,0,4,4,5,0,0,1,3,18
2018,Russell Westbrook\westbru01,PG,30,OKC,73,73,2630,630,1473,0.428,119,411,0.29,511,1062,0.481,0.468,296,451,0.656,109,698,807,784,142,33,325,245,1675
2018,Derrick White\whitede01,PG,24,SAS,67,55,1728,260,543,0.479,48,142,0.338,212,401,0.529,0.523,95,123,0.772,35,212,247,263,67,47,97,145,663
2018,Okaro White\whiteok01,PF,26,WAS,3,0,6,0,2,0,0,2,0,0,0,,0,0,0,,1,1,2,0,0,0,0,0,0
2018,Hassan Whiteside\whiteha01,C,29,MIA,72,53,1674,388,680,0.571,2,16,0.125,386,664,0.581,0.572,109,243,0.449,257,560,817,56,46,136,97,192,887
2018,Andrew Wiggins\wiggian01,SF,23,MIN,73,73,2543,498,1209,0.412,118,348,0.339,380,861,0.441,0.461,207,296,0.699,83,269,352,184,70,48,138,153,1321
2018,Alan Williams\willial03,PF,26,BRK,5,0,26,8,13,0.615,0,1,0,8,12,0.667,0.615,2,4,0.5,4,15,19,3,1,0,1,2,18
2018,C.J. Williams\willicj01,SG,28,MIN,15,0,128,17,35,0.486,5,16,0.313,12,19,0.632,0.557,0,1,0,1,7,8,12,6,0,5,16,39
2018,Johnathan Williams\willijo04,C,23,LAL,24,0,372,65,110,0.591,0,2,0,65,108,0.602,0.591,27,48,0.563,48,51,99,13,8,7,16,62,157
2018,Kenrich Williams\willike04,SF,24,NOP,46,29,1079,107,279,0.384,52,156,0.333,55,123,0.447,0.477,13,19,0.684,55,164,219,83,45,19,36,95,279
2018,Lou Williams\willilo02,SG,32,LAC,75,1,1993,484,1138,0.425,105,291,0.361,379,847,0.447,0.471,425,485,0.876,40,182,222,402,57,11,181,80,1498
2018,Marvin Williams\willima02,PF,32,CHO,75,75,2133,275,652,0.422,140,382,0.366,135,270,0.5,0.529,66,86,0.767,76,331,407,92,71,61,47,156,756
2018,Robert Williams\williro04,C,21,BOS,32,2,283,36,51,0.706,0,0,,36,51,0.706,0.706,9,15,0.6,27,54,81,7,9,40,10,36,81
2018,Troy Williams\willitr02,SF,24,SAC,21,0,312,44,98,0.449,14,44,0.318,30,54,0.556,0.52,9,15,0.6,12,47,59,11,10,8,9,37,111
2018,D.J. Wilson\wilsodj01,PF,22,MIL,48,3,882,104,251,0.414,46,127,0.362,58,124,0.468,0.506,26,47,0.553,45,177,222,52,18,20,32,85,280
2018,Justise Winslow\winslju01,SF,22,MIA,66,52,1959,324,749,0.433,96,256,0.375,228,493,0.462,0.497,86,137,0.628,63,292,355,282,72,19,142,177,830
2018,Christian Wood\woodch01,PF,23,TOT,21,2,251,61,117,0.521,9,26,0.346,52,91,0.571,0.56,41,56,0.732,17,66,83,8,7,10,17,17,172
2018,Christian Wood\woodch01,PF,23,MIL,13,0,62,12,25,0.48,3,5,0.6,9,20,0.45,0.54,10,15,0.667,4,16,20,2,0,0,3,3,37
2018,Christian Wood\woodch01,PF,23,NOP,8,2,189,49,92,0.533,6,21,0.286,43,71,0.606,0.565,31,41,0.756,13,50,63,6,7,10,14,14,135
2018,Delon Wright\wrighde01,PG,26,TOT,75,13,1699,242,558,0.434,50,168,0.298,192,390,0.492,0.478,119,150,0.793,68,198,266,248,88,30,77,103,653
2018,Delon Wright\wrighde01,PG,26,TOR,49,2,897,127,293,0.433,30,90,0.333,97,203,0.478,0.485,53,61,0.869,39,86,125,110,46,15,37,53,337
2018,Delon Wright\wrighde01,PG,26,MEM,26,11,802,115,265,0.434,20,78,0.256,95,187,0.508,0.472,66,89,0.742,29,112,141,138,42,15,40,50,316
2018,Guerschon Yabusele\yabusgu01,PF,23,BOS,41,1,251,35,77,0.455,9,28,0.321,26,49,0.531,0.513,15,22,0.682,23,30,53,15,8,7,15,32,94
2018,Nick Young\youngni01,SG,33,DEN,4,0,37,3,9,0.333,3,8,0.375,0,1,0,0.5,0,0,,0,1,1,2,0,1,2,4,9
2018,Thaddeus Young\youngth01,PF,30,IND,81,81,2489,443,841,0.527,51,146,0.349,392,695,0.564,0.557,87,135,0.644,192,331,523,204,123,36,123,194,1024
2018,Trae Young\youngtr01,PG,20,ATL,81,81,2503,525,1256,0.418,156,482,0.324,369,774,0.477,0.48,343,414,0.829,64,237,301,653,72,15,308,140,1549
2018,Cody Zeller\zelleco01,C,26,CHO,49,47,1243,190,345,0.551,6,22,0.273,184,323,0.57,0.559,111,141,0.787,110,223,333,102,38,41,62,164,497
2018,Tyler Zeller\zellety01,C,29,TOT,6,1,93,16,30,0.533,0,1,0,16,29,0.552,0.533,14,18,0.778,11,13,24,4,1,3,4,20,46
2018,Tyler Zeller\zellety01,C,29,ATL,2,0,11,0,2,0,0,1,0,0,1,0,0,0,0,,2,4,6,1,0,0,0,4,0
2018,Tyler Zeller\zellety01,C,29,MEM,4,1,82,16,28,0.571,0,0,,16,28,0.571,0.571,14,18,0.778,9,9,18,3,1,3,4,16,46
2018,Ante Žižić\zizican01,C,22,CLE,59,25,1082,183,331,0.553,0,0,,183,331,0.553,0.553,93,132,0.705,108,212,320,53,13,22,61,113,459
2018,Ivica Zubac\zubaciv01,C,21,TOT,59,37,1040,212,379,0.559,0,0,,212,379,0.559,0.559,101,126,0.802,115,247,362,63,14,51,70,137,525
2018,Ivica Zubac\zubaciv01,C,21,LAL,33,12,516,112,193,0.58,0,0,,112,193,0.58,0.58,57,66,0.864,54,108,162,25,4,27,33,73,281
2018,Ivica Zubac\zubaciv01,C,21,LAC,26,25,524,100,186,0.538,0,0,,100,186,0.538,0.538,44,60,0.733,61,139,200,38,10,24,37,64,244
2017,Álex Abrines\abrinal01,SG,24,OKC,75,8,1134,115,291,0.395,84,221,0.38,31,70,0.443,0.54,39,46,0.848,26,88,114,28,38,8,25,124,353
2017,Quincy Acy\acyqu01,PF,27,BRK,70,8,1359,130,365,0.356,102,292,0.349,28,73,0.384,0.496,49,60,0.817,40,217,257,57,33,29,60,149,411
2017,Steven Adams\adamsst01,C,24,OKC,76,76,2487,448,712,0.629,0,2,0,448,710,0.631,0.629,160,286,0.559,384,301,685,88,92,78,128,215,1056
2017,Bam Adebayo\adebaba01,C,20,MIA,69,19,1368,174,340,0.512,0,7,0,174,333,0.523,0.512,129,179,0.721,118,263,381,101,32,41,66,138,477
2017,Arron Afflalo\afflaar01,SG,32,ORL,53,3,682,65,162,0.401,27,70,0.386,38,92,0.413,0.485,22,26,0.846,4,62,66,30,4,9,21,56,179
2017,Cole Aldrich\aldrico01,C,29,MIN,21,0,49,5,15,0.333,0,0,,5,15,0.333,0.333,2,6,0.333,3,12,15,3,2,1,1,11,12
2017,LaMarcus Aldridge\aldrila01,C,32,SAS,75,75,2509,687,1347,0.51,27,92,0.293,660,1255,0.526,0.52,334,399,0.837,246,389,635,152,43,90,111,161,1735
2017,Jarrett Allen\allenja01,C,19,BRK,72,31,1441,234,397,0.589,5,15,0.333,229,382,0.599,0.596,114,147,0.776,144,244,388,49,28,88,82,147,587
2017,Kadeem Allen\allenka01,PG,25,BOS,18,1,107,6,22,0.273,0,11,0,6,11,0.545,0.273,7,9,0.778,4,7,11,12,3,2,9,15,19
2017,Tony Allen\allento01,SF,36,NOP,22,0,273,44,91,0.484,4,12,0.333,40,79,0.506,0.505,11,21,0.524,20,27,47,9,11,3,19,49,103
2017,Al-Farouq Aminu\aminual01,PF,27,POR,69,67,2072,230,582,0.395,125,339,0.369,105,243,0.432,0.503,59,80,0.738,97,428,525,84,79,40,79,136,644
2017,Justin Anderson\anderju01,SF,24,PHI,38,0,519,87,202,0.431,34,103,0.33,53,99,0.535,0.515,28,38,0.737,25,68,93,25,15,7,16,54,236
2017,Kyle Anderson\anderky01,SF,24,SAS,74,67,1978,231,438,0.527,19,57,0.333,212,381,0.556,0.549,104,146,0.712,84,312,396,202,115,60,94,114,585
2017,Ryan Anderson\anderry01,PF,29,HOU,66,50,1725,207,480,0.431,131,339,0.386,76,141,0.539,0.568,72,93,0.774,94,237,331,60,24,21,42,126,617
2017,Ike Anigbogu\anigbik01,C,19,IND,11,0,30,4,9,0.444,0,0,,4,9,0.444,0.444,5,6,0.833,5,4,9,0,1,3,2,1,13
2017,Giannis Antetokounmpo\antetgi01,PF,23,MIL,75,75,2756,742,1402,0.529,43,140,0.307,699,1262,0.554,0.545,487,641,0.76,156,597,753,361,109,106,223,231,2014
2017,Carmelo Anthony\anthoca01,PF,33,OKC,78,78,2501,472,1168,0.404,169,474,0.357,303,694,0.437,0.476,148,193,0.767,67,386,453,103,47,49,99,197,1261
2017,OG Anunoby\anunoog01,SF,20,TOR,74,62,1481,163,346,0.471,73,197,0.371,90,149,0.604,0.577,39,62,0.629,44,140,184,55,52,14,45,130,438
2017,Ryan Arcidiacono\arcidry01,PG,23,CHI,24,0,304,17,41,0.415,9,31,0.29,8,10,0.8,0.524,5,6,0.833,1,24,25,35,13,0,13,18,48
2017,Trevor Ariza\arizatr01,SF,32,HOU,67,67,2269,268,651,0.412,170,462,0.368,98,189,0.519,0.542,76,89,0.854,33,261,294,105,98,13,52,132,782
2017,Darrell Arthur\arthuda01,PF,29,DEN,19,1,141,22,47,0.468,8,23,0.348,14,24,0.583,0.553,2,3,0.667,3,12,15,9,8,3,15,22,54
2017,Jamel Artis\artisja01,SG,25,ORL,15,1,279,31,79,0.392,8,29,0.276,23,50,0.46,0.443,7,12,0.583,4,34,38,18,2,3,8,11,77
2017,Ömer Aşık\asikom01,C,31,TOT,18,0,182,9,22,0.409,0,0,,9,22,0.409,0.409,4,13,0.308,9,38,47,3,2,4,9,20,22
2017,Ömer Aşık\asikom01,C,31,NOP,14,0,121,7,16,0.438,0,0,,7,16,0.438,0.438,4,12,0.333,7,30,37,2,1,2,5,14,18
2017,Ömer Aşık\asikom01,C,31,CHI,4,0,61,2,6,0.333,0,0,,2,6,0.333,0.333,0,1,0,2,8,10,1,1,2,4,6,4
2017,D.J. Augustin\augusdj01,PG,30,ORL,75,36,1760,244,540,0.452,114,272,0.419,130,268,0.485,0.557,164,189,0.868,30,130,160,287,54,0,123,94,766
2017,Luke Babbitt\babbilu01,SF,28,TOT,50,14,715,91,215,0.423,60,156,0.385,31,59,0.525,0.563,17,22,0.773,7,89,96,31,8,7,19,54,259
2017,Luke Babbitt\babbilu01,SF,28,ATL,37,9,570,80,168,0.476,49,111,0.441,31,57,0.544,0.622,17,22,0.773,5,76,81,26,7,5,15,47,226
2017,Luke Babbitt\babbilu01,SF,28,MIA,13,5,145,11,47,0.234,11,45,0.244,0,2,0,0.351,0,0,,2,13,15,5,1,2,4,7,33
2017,Dwayne Bacon\bacondw01,SG,22,CHO,53,6,713,72,192,0.375,11,43,0.256,61,149,0.409,0.404,20,25,0.8,4,120,124,38,16,2,23,46,175
2017,Ron Baker\bakerro01,SG,24,NYK,29,1,385,20,59,0.339,11,33,0.333,9,26,0.346,0.432,20,26,0.769,5,25,30,47,26,6,18,33,71
2017,Wade Baldwin\baldwwa01,PG,21,POR,7,0,80,14,21,0.667,4,5,0.8,10,16,0.625,0.762,6,10,0.6,1,7,8,5,2,1,4,12,38
2017,Lonzo Ball\balllo01,PG,20,LAL,52,50,1780,203,564,0.36,90,295,0.305,113,269,0.42,0.44,32,71,0.451,69,291,360,376,88,43,136,117,528
2017,J.J. Barea\bareajo01,PG,33,DAL,69,10,1603,303,690,0.439,115,313,0.367,188,377,0.499,0.522,80,102,0.784,15,186,201,434,35,3,143,83,801
2017,Harrison Barnes\barneha02,PF,25,DAL,77,77,2634,537,1208,0.445,119,333,0.357,418,875,0.478,0.494,259,313,0.827,77,391,468,152,49,14,118,94,1452
2017,Will Barton\bartowi01,SG,27,DEN,81,40,2683,465,1028,0.452,156,422,0.37,309,606,0.51,0.528,182,226,0.805,70,339,409,331,82,52,149,168,1268
2017,Nicolas Batum\batumni01,SG,29,CHO,64,64,1981,270,650,0.415,92,274,0.336,178,376,0.473,0.486,108,130,0.831,57,249,306,349,65,23,131,72,740
2017,Jerryd Bayless\bayleje01,SG,29,PHI,39,11,925,109,262,0.416,54,146,0.37,55,116,0.474,0.519,35,44,0.795,15,65,80,54,23,6,46,91,307
2017,Aron Baynes\baynear01,C,31,BOS,81,67,1485,210,446,0.471,3,21,0.143,207,425,0.487,0.474,59,78,0.756,130,304,434,93,22,51,80,200,482
2017,Kent Bazemore\bazemke01,SG,28,ATL,65,65,1789,284,676,0.42,108,274,0.394,176,402,0.438,0.5,160,201,0.796,25,223,248,228,100,45,157,147,836
2017,Bradley Beal\bealbr01,SG,24,WAS,82,82,2977,683,1484,0.46,199,530,0.375,484,954,0.507,0.527,292,369,0.791,61,302,363,373,96,36,214,160,1857
2017,Malik Beasley\beaslma01,SG,21,DEN,62,0,583,73,178,0.41,28,82,0.341,45,96,0.469,0.489,22,33,0.667,14,57,71,31,15,7,24,36,196
2017,Michael Beasley\beaslmi01,PF,29,NYK,74,30,1653,409,807,0.507,34,86,0.395,375,721,0.52,0.528,124,159,0.78,97,317,414,123,36,43,143,145,976
2017,Marco Belinelli\belinma01,SG,31,TOT,80,2,1947,337,764,0.441,149,395,0.377,188,369,0.509,0.539,148,163,0.908,20,131,151,148,66,12,94,91,971
2017,Marco Belinelli\belinma01,SG,31,ATL,52,1,1210,199,485,0.41,92,247,0.372,107,238,0.45,0.505,101,109,0.927,14,86,100,103,46,3,54,41,591
2017,Marco Belinelli\belinma01,SG,31,PHI,28,1,737,138,279,0.495,57,148,0.385,81,131,0.618,0.597,47,54,0.87,6,45,51,45,20,9,40,50,380
2017,Jordan Bell\belljo01,C,23,GSW,57,13,809,116,185,0.627,0,4,0,116,181,0.641,0.627,30,44,0.682,60,147,207,102,35,56,51,92,262
2017,DeAndre' Bembry\bembrde01,SF,23,ATL,26,3,455,53,128,0.414,11,30,0.367,42,98,0.429,0.457,19,33,0.576,8,64,72,49,21,12,47,38,136
2017,Dragan Bender\bendedr01,PF,20,PHO,82,37,2069,187,484,0.386,118,322,0.366,69,162,0.426,0.508,39,51,0.765,40,321,361,130,22,53,112,166,531
2017,Dāvis Bertāns\bertada01,PF,25,SAS,77,10,1086,161,366,0.44,94,252,0.373,67,114,0.588,0.568,40,49,0.816,18,135,153,74,26,28,36,93,456
2017,Patrick Beverley\beverpa01,SG,29,LAC,11,11,334,48,119,0.403,24,60,0.4,24,59,0.407,0.504,14,17,0.824,16,29,45,32,19,5,25,34,134
2017,Khem Birch\birchkh01,C,25,ORL,42,0,578,68,126,0.54,0,0,,68,126,0.54,0.54,42,61,0.689,70,110,180,34,15,21,21,56,178
2017,Jabari Bird\birdja01,SG,23,BOS,13,1,115,15,26,0.577,3,7,0.429,12,19,0.632,0.635,6,13,0.462,6,13,19,8,3,1,8,7,39
2017,Bismack Biyombo\biyombi01,C,25,ORL,82,25,1495,183,352,0.52,0,1,0,183,351,0.521,0.52,102,157,0.65,144,324,468,66,21,95,84,158,468
2017,Nemanja Bjelica\bjeline01,PF,29,MIN,67,21,1371,171,371,0.461,76,183,0.415,95,188,0.505,0.563,36,45,0.8,53,221,274,86,50,16,52,141,454
2017,Tarik Black\blackta01,C,26,HOU,51,2,536,75,127,0.591,1,11,0.091,74,116,0.638,0.594,29,63,0.46,63,100,163,13,21,30,35,107,180
2017,Antonio Blakeney\blakean01,SG,21,CHI,19,0,314,53,143,0.371,15,52,0.288,38,91,0.418,0.423,30,39,0.769,4,29,33,20,7,1,11,19,151
2017,Eric Bledsoe\bledser01,PG,28,TOT,74,74,2322,468,989,0.473,125,360,0.347,343,629,0.545,0.536,252,317,0.795,51,233,284,370,149,42,216,185,1313
2017,Eric Bledsoe\bledser01,PG,28,PHO,3,3,83,16,40,0.4,4,13,0.308,12,27,0.444,0.45,11,14,0.786,3,4,7,9,4,2,10,6,47
2017,Eric Bledsoe\bledser01,PG,28,MIL,71,71,2239,452,949,0.476,121,347,0.349,331,602,0.55,0.54,241,303,0.795,48,229,277,361,145,40,206,179,1266
2017,Vander Blue\blueva01,SG,25,LAL,5,0,45,1,5,0.2,0,2,0,1,3,0.333,0.2,1,2,0.5,0,1,1,3,1,0,3,2,3
2017,Bogdan Bogdanović\bogdabo01,SG,25,SAC,78,53,2175,344,772,0.446,129,329,0.392,215,443,0.485,0.529,100,119,0.84,31,192,223,258,72,16,125,172,917
2017,Bojan Bogdanović\bogdabo02,SF,28,IND,80,80,2464,404,852,0.474,155,386,0.402,249,466,0.534,0.565,178,205,0.868,30,240,270,119,55,8,106,129,1141
2017,Andrew Bogut\bogutan01,C,33,LAL,24,5,216,17,25,0.68,0,0,,17,25,0.68,0.68,2,2,1,26,52,78,15,4,13,19,40,36
2017,Joel Bolomboy\bolomjo01,PF,24,MIL,6,0,38,3,6,0.5,0,1,0,3,5,0.6,0.5,3,6,0.5,6,4,10,0,2,0,2,3,9
2017,Devin Booker\bookede01,SG,21,PHO,54,54,1865,455,1054,0.432,147,384,0.383,308,670,0.46,0.501,289,329,0.878,26,218,244,253,47,14,194,168,1346
2017,Trevor Booker\booketr01,PF,30,TOT,68,7,1158,177,343,0.516,8,33,0.242,169,310,0.545,0.528,66,93,0.71,117,201,318,82,28,21,59,119,428
2017,Trevor Booker\booketr01,PF,30,BRK,18,6,395,77,150,0.513,3,12,0.25,74,138,0.536,0.523,24,43,0.558,38,81,119,38,8,5,30,43,181
2017,Trevor Booker\booketr01,PF,30,PHI,33,0,494,61,109,0.56,2,7,0.286,59,102,0.578,0.569,32,39,0.821,47,75,122,27,16,11,20,50,156
2017,Trevor Booker\booketr01,PF,30,IND,17,1,269,39,84,0.464,3,14,0.214,36,70,0.514,0.482,10,11,0.909,32,45,77,17,4,5,9,26,91
2017,Chris Boucher\bouchch01,PF,25,GSW,1,0,1,0,1,0,0,1,0,0,0,,0,0,0,,0,1,1,0,0,0,0,0,0
2017,Avery Bradley\bradlav01,SG,27,TOT,46,46,1433,259,625,0.414,75,203,0.369,184,422,0.436,0.474,63,82,0.768,22,94,116,94,51,8,101,92,656
2017,Avery Bradley\bradlav01,SG,27,DET,40,40,1268,233,570,0.409,74,194,0.381,159,376,0.423,0.474,61,80,0.763,19,75,94,83,46,7,93,80,601
2017,Avery Bradley\bradlav01,SG,27,LAC,6,6,165,26,55,0.473,1,9,0.111,25,46,0.543,0.482,2,2,1,3,19,22,11,5,1,8,12,55
2017,Tony Bradley\bradlto01,C,20,UTA,9,0,29,3,11,0.273,0,1,0,3,10,0.3,0.273,2,2,1,4,7,11,1,0,0,0,1,8
2017,Corey Brewer\breweco01,SF-SG,31,TOT,72,18,1208,142,316,0.449,31,110,0.282,111,206,0.539,0.498,65,90,0.722,43,111,154,65,79,14,49,139,380
2017,Corey Brewer\breweco01,SF,31,LAL,54,2,694,78,172,0.453,8,43,0.186,70,129,0.543,0.477,34,51,0.667,23,70,93,41,41,8,38,83,198
2017,Corey Brewer\breweco01,SG,31,OKC,18,16,514,64,144,0.444,23,67,0.343,41,77,0.532,0.524,31,39,0.795,20,41,61,24,38,6,11,56,182
2017,Malcolm Brogdon\brogdma01,PG,25,MIL,48,20,1436,244,503,0.485,62,161,0.385,182,342,0.532,0.547,75,85,0.882,23,133,156,152,41,13,66,128,625
2017,Aaron Brooks\brookaa01,PG,33,MIN,32,1,189,28,69,0.406,11,31,0.355,17,38,0.447,0.486,8,11,0.727,7,10,17,20,6,0,11,28,75
2017,Dillon Brooks\brookdi01,SF,22,MEM,82,74,2350,340,772,0.44,94,264,0.356,246,508,0.484,0.501,124,166,0.747,49,208,257,135,73,17,124,233,898
2017,MarShon Brooks\brookma01,SG,29,MEM,7,1,193,51,102,0.5,19,32,0.594,32,70,0.457,0.593,20,23,0.87,8,13,21,25,11,3,16,6,141
2017,Anthony Brown\brownan02,SF,25,MIN,1,0,4,1,1,1,1,1,1,0,0,,1.5,0,0,,0,0,0,1,0,0,0,0,3
2017,Bobby Brown\brownbo02,PG,33,HOU,20,0,115,19,58,0.328,11,40,0.275,8,18,0.444,0.422,1,2,0.5,0,7,7,11,4,0,9,6,50
2017,Jaylen Brown\brownja02,SG,21,BOS,70,70,2152,373,803,0.465,121,306,0.395,252,497,0.507,0.54,150,233,0.644,66,280,346,114,70,26,124,181,1017
2017,Lorenzo Brown\brownlo01,PG,27,TOR,14,0,139,14,34,0.412,2,12,0.167,12,22,0.545,0.441,2,2,1,1,14,15,13,5,0,3,7,32
2017,Markel Brown\brownma02,SG,26,HOU,4,0,31,2,7,0.286,1,5,0.2,1,2,0.5,0.357,0,0,,1,4,5,2,0,0,2,6,5
2017,Sterling Brown\brownst02,SG,22,MIL,54,4,776,82,205,0.4,32,91,0.352,50,114,0.439,0.478,21,24,0.875,27,116,143,25,31,13,25,80,217
2017,Nicolás Brussino\brussni01,SF,24,ATL,4,0,10,0,2,0,0,2,0,0,0,,0,0,0,,0,3,3,0,0,0,0,0,0
2017,Thomas Bryant\bryanth01,C,20,LAL,15,0,72,8,21,0.381,1,10,0.1,7,11,0.636,0.405,5,9,0.556,3,14,17,6,1,2,2,6,22
2017,Reggie Bullock\bullore01,SF,26,DET,62,52,1732,267,546,0.489,125,281,0.445,142,265,0.536,0.603,39,49,0.796,27,127,154,95,47,13,47,70,698
2017,Trey Burke\burketr01,PG,25,NYK,36,9,785,193,384,0.503,38,105,0.362,155,279,0.556,0.552,37,57,0.649,13,58,71,170,24,4,43,43,461
2017,Alec Burks\burksal01,SG,26,UTA,64,1,1059,170,414,0.411,47,142,0.331,123,272,0.452,0.467,107,124,0.863,19,173,192,67,37,8,60,75,494
2017,Jimmy Butler\butleji01,SG,28,MIN,59,59,2164,437,921,0.474,70,200,0.35,367,721,0.509,0.512,363,425,0.854,79,235,314,288,116,24,108,78,1307
2017,Dwight Buycks\buyckdw01,PG,28,DET,29,0,427,82,198,0.414,15,45,0.333,67,153,0.438,0.452,36,41,0.878,12,29,41,59,19,2,39,39,215
2017,Bruno Caboclo\cabocbr01,SF,22,TOT,12,0,107,9,31,0.29,3,17,0.176,6,14,0.429,0.339,5,6,0.833,7,15,22,4,3,4,4,8,26
2017,Bruno Caboclo\cabocbr01,SF,22,TOR,2,0,7,0,2,0,0,2,0,0,0,,0,0,0,,0,1,1,1,1,0,0,1,0
2017,Bruno Caboclo\cabocbr01,SF,22,SAC,10,0,100,9,29,0.31,3,15,0.2,6,14,0.429,0.362,5,6,0.833,7,14,21,3,2,4,4,7,26
2017,José Calderón\caldejo01,PG,36,CLE,57,32,914,93,185,0.503,45,97,0.464,48,88,0.545,0.624,24,30,0.8,14,70,84,117,27,2,41,81,255
2017,Kentavious Caldwell-Pope\caldwke01,SG,24,LAL,74,74,2458,340,798,0.426,159,415,0.383,181,383,0.473,0.526,153,194,0.789,60,327,387,162,106,16,97,145,992
2017,Isaiah Canaan\canaais01,PG-SG,26,TOT,20,1,422,52,137,0.38,22,66,0.333,30,71,0.423,0.46,46,51,0.902,6,39,45,76,16,1,29,36,172
2017,Isaiah Canaan\canaais01,SG,26,HOU,1,0,4,0,1,0,0,0,,0,1,0,0,0,0,,0,1,1,0,0,0,0,0,0
2017,Isaiah Canaan\canaais01,PG,26,PHO,19,1,418,52,136,0.382,22,66,0.333,30,70,0.429,0.463,46,51,0.902,6,38,44,76,16,1,29,36,172
2017,Clint Capela\capelca01,C,23,HOU,74,74,2034,441,676,0.652,0,1,0,441,675,0.653,0.652,144,257,0.56,241,561,802,68,58,137,103,185,1026
2017,DeMarre Carroll\carrode01,PF,31,BRK,73,73,2180,325,785,0.414,145,391,0.371,180,394,0.457,0.506,188,246,0.764,105,374,479,147,59,30,103,165,983
2017,Vince Carter\cartevi01,SF,41,SAC,58,5,1026,114,283,0.403,57,165,0.345,57,118,0.483,0.504,28,37,0.757,18,130,148,69,42,26,36,96,313
2017,Michael Carter-Williams\cartemi01,PG,26,CHO,52,2,835,76,229,0.332,14,59,0.237,62,170,0.365,0.362,73,89,0.82,37,101,138,116,44,23,52,99,239
2017,Alex Caruso\carusal01,PG,23,LAL,37,7,562,50,116,0.431,13,43,0.302,37,73,0.507,0.487,21,30,0.7,15,50,65,75,23,10,42,52,134
2017,Omri Casspi\casspom01,SF,29,GSW,53,7,740,120,207,0.58,10,22,0.455,110,185,0.595,0.604,50,69,0.725,30,170,200,51,18,19,37,71,300
2017,Willie Cauley-Stein\caulewi01,C,24,SAC,73,58,2044,388,773,0.502,3,12,0.25,385,761,0.506,0.504,153,247,0.619,131,379,510,172,77,67,109,185,932
2017,Tyler Cavanaugh\cavanty01,PF,23,ATL,39,1,518,67,152,0.441,32,89,0.36,35,63,0.556,0.546,17,21,0.81,45,82,127,27,9,4,14,61,183
2017,Mario Chalmers\chalmma01,PG,31,MEM,66,10,1421,168,443,0.379,53,191,0.277,115,252,0.456,0.439,118,138,0.855,13,144,157,197,79,14,117,179,507
2017,Tyson Chandler\chandty01,C,35,PHO,46,46,1151,121,187,0.647,0,0,,121,187,0.647,0.647,58,93,0.624,134,284,418,53,16,27,59,106,300
2017,Wilson Chandler\chandwi01,SF,30,DEN,74,71,2346,281,631,0.445,88,246,0.358,193,385,0.501,0.515,88,114,0.772,102,296,398,159,43,39,92,156,738
2017,Marquese Chriss\chrisma01,PF,20,PHO,72,49,1527,202,477,0.423,56,190,0.295,146,287,0.509,0.482,96,158,0.608,76,319,395,83,51,70,107,205,556
2017,Ian Clark\clarkia01,SG,26,NOP,74,2,1455,222,495,0.448,62,195,0.318,160,300,0.533,0.511,45,59,0.763,10,117,127,110,33,10,57,120,551
2017,Jordan Clarkson\clarkjo01,SG,25,TOT,81,2,1888,430,954,0.451,112,318,0.352,318,636,0.5,0.509,152,190,0.8,57,160,217,221,58,6,127,107,1124
2017,Jordan Clarkson\clarkjo01,SG,25,LAL,53,2,1256,299,667,0.448,68,210,0.324,231,457,0.505,0.499,105,132,0.795,44,115,159,173,39,3,95,63,771
2017,Jordan Clarkson\clarkjo01,SG,25,CLE,28,0,632,131,287,0.456,44,108,0.407,87,179,0.486,0.533,47,58,0.81,13,45,58,48,19,3,32,44,353
2017,Gian Clavell\clavegi01,SG,24,DAL,7,0,64,6,18,0.333,6,15,0.4,0,3,0,0.5,2,2,1,1,6,7,3,2,0,2,8,20
2017,Antonius Cleveland\clevean01,SG,23,TOT,17,0,123,8,21,0.381,3,4,0.75,5,17,0.294,0.452,4,6,0.667,3,11,14,2,7,5,7,23,23
2017,Antonius Cleveland\clevean01,SG,23,DAL,13,0,81,4,14,0.286,0,1,0,4,13,0.308,0.286,2,4,0.5,2,8,10,2,6,4,2,11,10
2017,Antonius Cleveland\clevean01,SG,23,ATL,4,0,42,4,7,0.571,3,3,1,1,4,0.25,0.786,2,2,1,1,3,4,0,1,1,5,12,13
2017,John Collins\collijo01,PF,20,ATL,74,26,1785,314,545,0.576,16,47,0.34,298,498,0.598,0.591,133,186,0.715,176,365,541,98,47,80,105,215,777
2017,Zach Collins\colliza01,C,20,POR,66,1,1045,115,289,0.398,35,113,0.31,80,176,0.455,0.458,27,42,0.643,45,176,221,52,17,31,58,133,292
2017,Kyle Collinsworth\colliky01,SF,26,DAL,32,2,480,38,99,0.384,4,17,0.235,34,82,0.415,0.404,21,40,0.525,32,75,107,56,17,9,24,44,101
2017,Darren Collison\collida01,PG,30,IND,69,64,2018,316,638,0.495,96,205,0.468,220,433,0.508,0.571,127,144,0.882,37,141,178,368,92,15,86,122,855
2017,Nick Collison\collini01,PF,37,OKC,15,0,75,13,19,0.684,0,0,,13,19,0.684,0.684,5,13,0.385,7,13,20,4,0,0,7,7,31
2017,Mike Conley\conlemi01,PG,30,MEM,12,12,373,64,168,0.381,24,77,0.312,40,91,0.44,0.452,53,66,0.803,0,27,27,49,12,3,18,24,205
2017,Pat Connaughton\connapa01,SG,25,POR,82,5,1488,165,390,0.423,74,210,0.352,91,180,0.506,0.518,37,44,0.841,36,125,161,91,23,22,43,120,441
2017,Quinn Cook\cookqu01,PG,24,GSW,33,18,740,122,252,0.484,46,104,0.442,76,148,0.514,0.575,22,25,0.88,10,72,82,89,12,1,32,59,312
2017,Charles Cooke\cookech01,SG,23,NOP,13,0,38,2,14,0.143,1,8,0.125,1,6,0.167,0.179,1,2,0.5,0,2,2,1,1,0,1,0,6
2017,Jack Cooley\cooleja01,PF,26,SAC,7,0,87,13,27,0.481,0,0,,13,27,0.481,0.481,14,19,0.737,14,16,30,6,1,0,3,13,40
2017,Matt Costello\costema01,C,24,SAS,4,0,32,2,4,0.5,0,0,,2,4,0.5,0.5,0,0,,1,8,9,2,2,2,1,7,4
2017,DeMarcus Cousins\couside01,C,27,NOP,48,48,1737,406,864,0.47,104,294,0.354,302,570,0.53,0.53,294,394,0.746,105,512,617,257,79,76,242,183,1210
2017,Robert Covington\covinro01,SF,27,PHI,80,80,2532,345,836,0.413,203,550,0.369,142,286,0.497,0.534,116,136,0.853,55,378,433,156,137,72,126,238,1009
2017,Allen Crabbe\crabbal01,SG,25,BRK,75,68,2197,337,827,0.407,201,532,0.378,136,295,0.461,0.529,115,135,0.852,28,296,324,117,47,35,78,168,990
2017,Torrey Craig\craigto01,SF,27,DEN,39,5,629,62,137,0.453,17,58,0.293,45,79,0.57,0.515,22,35,0.629,40,87,127,25,12,15,20,63,163
2017,Jamal Crawford\crawfja01,SG,37,MIN,80,0,1653,308,742,0.415,104,314,0.331,204,428,0.477,0.485,102,113,0.903,21,78,99,185,40,9,95,85,822
2017,Jordan Crawford\crawfjo02,SG,29,NOP,5,0,53,12,27,0.444,8,14,0.571,4,13,0.308,0.593,1,1,1,2,2,4,13,1,1,5,7,33
2017,Jae Crowder\crowdja01,SF,27,TOT,80,47,2090,271,671,0.404,110,341,0.323,161,330,0.488,0.486,121,148,0.818,59,216,275,99,64,21,74,187,773
2017,Jae Crowder\crowdja01,SF,27,CLE,53,47,1346,157,376,0.418,62,189,0.328,95,187,0.508,0.5,78,92,0.848,41,132,173,58,41,12,42,124,454
2017,Jae Crowder\crowdja01,SF,27,UTA,27,0,744,114,295,0.386,48,152,0.316,66,143,0.462,0.468,43,56,0.768,18,84,102,41,23,9,32,63,319
2017,Dante Cunningham\cunnida01,SF,30,TOT,73,25,1562,164,364,0.451,58,168,0.345,106,196,0.541,0.53,31,52,0.596,78,220,298,48,39,30,33,111,417
2017,Dante Cunningham\cunnida01,SF,30,NOP,51,24,1115,99,225,0.44,35,108,0.324,64,117,0.547,0.518,20,36,0.556,50,143,193,26,27,16,16,75,253
2017,Dante Cunningham\cunnida01,SF,30,BRK,22,1,447,65,139,0.468,23,60,0.383,42,79,0.532,0.55,11,16,0.688,28,77,105,22,12,14,17,36,164
2017,Stephen Curry\curryst01,PG,29,GSW,51,51,1631,428,864,0.495,212,501,0.423,216,363,0.595,0.618,278,302,0.921,36,225,261,310,80,8,153,114,1346
2017,Troy Daniels\danietr01,SG,26,PHO,79,15,1622,232,575,0.403,183,458,0.4,49,117,0.419,0.563,56,64,0.875,12,115,127,48,26,5,56,137,703
2017,Anthony Davis\davisan02,PF,24,NOP,75,75,2727,780,1462,0.534,55,162,0.34,725,1300,0.558,0.552,495,598,0.828,187,645,832,174,115,193,162,159,2110
2017,Deyonta Davis\davisde01,C,21,MEM,62,6,943,161,265,0.608,0,0,,161,265,0.608,0.608,38,57,0.667,75,175,250,40,15,39,32,125,360
2017,Ed Davis\davised01,C,28,POR,78,0,1471,170,292,0.582,0,1,0,170,291,0.584,0.582,74,111,0.667,183,392,575,40,32,52,66,188,414
2017,Dewayne Dedmon\dedmode01,C,28,ATL,62,46,1542,250,477,0.524,50,141,0.355,200,336,0.595,0.577,67,86,0.779,100,389,489,90,40,51,86,162,617
2017,Sam Dekker\dekkesa01,PF,23,LAC,73,1,883,128,259,0.494,10,60,0.167,118,199,0.593,0.514,37,56,0.661,44,130,174,38,24,9,33,71,303
2017,Malcolm Delaney\delanma01,PG,28,ATL,54,3,1014,109,285,0.382,46,124,0.371,63,161,0.391,0.463,74,92,0.804,9,91,100,163,35,6,66,82,338
2017,Matthew Dellavedova\dellama01,PG,27,MIL,38,3,712,55,152,0.362,29,78,0.372,26,74,0.351,0.457,25,27,0.926,14,50,64,145,14,0,49,67,164
2017,Luol Deng\denglu01,SF,32,LAL,1,1,13,1,2,0.5,0,0,,1,2,0.5,0.5,0,0,,0,0,0,1,1,0,1,0,2
2017,DeMar DeRozan\derozde01,SG,28,TOR,80,80,2711,645,1413,0.456,89,287,0.31,556,1126,0.494,0.488,461,559,0.825,59,256,315,417,85,22,175,151,1840
2017,Cheick Diallo\diallch01,PF,21,NOP,52,0,581,102,176,0.58,0,0,,102,176,0.58,0.58,50,66,0.758,47,164,211,19,11,21,28,82,254
2017,Gorgui Dieng\dienggo01,C,28,MIN,79,0,1333,186,388,0.479,19,61,0.311,167,327,0.511,0.504,79,102,0.775,106,254,360,71,45,39,59,147,470
2017,Spencer Dinwiddie\dinwisp01,PG,24,BRK,80,58,2306,324,838,0.387,141,433,0.326,183,405,0.452,0.471,218,268,0.813,40,219,259,524,68,23,128,186,1007
2017,Tyler Dorsey\dorsety01,SG,21,ATL,56,5,974,144,382,0.377,72,199,0.362,72,183,0.393,0.471,45,63,0.714,17,113,130,79,17,5,37,63,405
2017,Damyean Dotson\dotsoda01,SG,23,NYK,44,2,474,72,161,0.447,22,68,0.324,50,93,0.538,0.516,16,23,0.696,9,75,84,31,12,2,17,34,182
2017,Milton Doyle\doylemi01,SG,24,BRK,10,0,125,13,47,0.277,4,23,0.174,9,24,0.375,0.319,4,8,0.5,3,15,18,10,6,2,2,13,34
2017,PJ Dozier\doziepj01,PG,21,OKC,2,0,3,1,2,0.5,0,0,,1,2,0.5,0.5,0,0,,0,1,1,0,0,0,1,1,2
2017,Goran Dragić\dragigo01,PG,31,MIA,75,75,2378,484,1075,0.45,111,300,0.37,373,775,0.481,0.502,217,271,0.801,54,253,307,359,63,12,166,180,1296
2017,Larry Drew II\drewla02,PG,27,TOT,10,0,70,7,24,0.292,3,9,0.333,4,15,0.267,0.354,0,0,,3,0,3,10,0,0,3,6,17
2017,Larry Drew II\drewla02,PG,27,PHI,3,0,15,1,7,0.143,0,3,0,1,4,0.25,0.143,0,0,,1,0,1,2,0,0,1,2,2
2017,Larry Drew II\drewla02,PG,27,NOP,7,0,55,6,17,0.353,3,6,0.5,3,11,0.273,0.441,0,0,,2,0,2,8,0,0,2,4,15
2017,Andre Drummond\drumman01,C,24,DET,78,78,2625,466,881,0.529,0,11,0,466,870,0.536,0.529,239,395,0.605,399,848,1247,237,114,127,200,250,1171
2017,Jared Dudley\dudleja01,PF,32,PHO,48,0,686,48,122,0.393,29,80,0.363,19,42,0.452,0.512,27,35,0.771,8,86,94,78,24,11,28,85,152
2017,Kris Dunn\dunnkr01,PG,23,CHI,52,43,1525,286,666,0.429,43,134,0.321,243,532,0.457,0.462,84,114,0.737,24,197,221,310,104,27,150,174,699
2017,Kevin Durant\duranke01,SF,29,GSW,68,68,2325,630,1222,0.516,173,413,0.419,457,809,0.565,0.586,359,404,0.889,31,433,464,366,50,119,207,133,1792
2017,Jarell Eddie\eddieja01,SF,26,TOT,3,0,9,0,2,0,0,2,0,0,0,,0,0,0,,0,1,1,0,1,0,0,0,0
2017,Jarell Eddie\eddieja01,SF,26,BOS,2,0,6,0,1,0,0,1,0,0,0,,0,0,0,,0,1,1,0,1,0,0,0,0
2017,Jarell Eddie\eddieja01,SF,26,CHI,1,0,3,0,1,0,0,1,0,0,0,,0,0,0,,0,0,0,0,0,0,0,0,0
2017,Henry Ellenson\ellenhe01,PF,21,DET,38,0,329,53,146,0.363,20,60,0.333,33,86,0.384,0.432,25,29,0.862,10,71,81,20,5,0,18,22,151
2017,Wayne Ellington\ellinwa01,SG,30,MIA,77,2,2041,285,700,0.407,227,579,0.392,58,121,0.479,0.569,67,78,0.859,23,195,218,79,53,8,52,94,864
2017,Joel Embiid\embiijo01,C,23,PHI,63,63,1912,510,1056,0.483,66,214,0.308,444,842,0.527,0.514,359,467,0.769,143,547,690,199,40,111,234,209,1445
2017,James Ennis\ennisja01,SF,27,TOT,72,22,1604,182,384,0.474,51,153,0.333,131,231,0.567,0.54,97,116,0.836,73,151,224,71,47,18,56,134,512
2017,James Ennis\ennisja01,SF,27,MEM,45,14,1053,108,222,0.486,30,84,0.357,78,138,0.565,0.554,64,73,0.877,53,104,157,49,32,12,38,81,310
2017,James Ennis\ennisja01,SF,27,DET,27,8,551,74,162,0.457,21,69,0.304,53,93,0.57,0.522,33,43,0.767,20,47,67,22,15,6,18,53,202
2017,Tyler Ennis\ennisty01,PG,23,LAL,54,11,683,94,224,0.42,14,56,0.25,80,168,0.476,0.451,22,29,0.759,19,76,95,105,30,10,38,75,224
2017,Jawun Evans\evansja01,PG,21,LAC,48,4,778,89,253,0.352,15,54,0.278,74,199,0.372,0.381,38,49,0.776,9,75,84,100,36,6,44,97,231
2017,Jeremy Evans\evansje01,SF,30,ATL,1,0,5,1,1,1,0,0,,1,1,1,1,0,0,,1,0,1,0,0,0,1,1,2
2017,Tyreke Evans\evansty01,PG,28,MEM,52,32,1607,366,809,0.452,114,286,0.399,252,523,0.482,0.523,164,209,0.785,44,221,265,269,57,17,117,96,1010
2017,Dante Exum\exumda01,PG,22,UTA,14,0,235,42,87,0.483,5,18,0.278,37,69,0.536,0.511,25,31,0.806,4,22,26,43,8,3,20,20,114
2017,Kenneth Faried\farieke01,PF,28,DEN,32,7,461,76,148,0.514,0,1,0,76,147,0.517,0.514,36,51,0.706,68,85,153,18,12,13,23,51,188
2017,Derrick Favors\favorde01,C,26,UTA,77,77,2153,395,702,0.563,14,63,0.222,381,639,0.596,0.573,140,215,0.651,198,354,552,102,54,82,88,164,944
2017,Kay Felder\feldeka01,PG,22,TOT,16,0,140,21,70,0.3,4,19,0.211,17,51,0.333,0.329,11,12,0.917,3,15,18,20,3,1,16,11,57
2017,Kay Felder\feldeka01,PG,22,CHI,14,0,134,20,66,0.303,4,18,0.222,16,48,0.333,0.333,11,12,0.917,1,13,14,20,3,1,15,11,55
2017,Kay Felder\feldeka01,PG,22,DET,2,0,6,1,4,0.25,0,1,0,1,3,0.333,0.25,0,0,,2,2,4,0,0,0,1,0,2
2017,Cristiano Felício\feliccr01,C,25,CHI,55,16,977,127,215,0.591,0,2,0,127,213,0.596,0.591,54,81,0.667,83,150,233,55,16,11,54,104,308
2017,Raymond Felton\feltora01,PG,33,OKC,82,2,1365,224,552,0.406,81,230,0.352,143,322,0.444,0.479,36,44,0.818,25,131,156,203,49,16,76,91,565
2017,Terrance Ferguson\fergute01,SG,19,OKC,61,12,763,70,169,0.414,40,120,0.333,30,49,0.612,0.533,9,10,0.9,19,28,47,19,24,10,11,83,189
2017,Yogi Ferrell\ferreyo01,SG,24,DAL,82,21,2282,311,730,0.426,134,359,0.373,177,371,0.477,0.518,82,103,0.796,26,223,249,201,64,9,78,153,838
2017,Dorian Finney-Smith\finnedo01,PF,24,DAL,21,13,448,46,121,0.38,20,67,0.299,26,54,0.481,0.463,11,15,0.733,22,53,75,26,10,4,21,43,123
2017,Bryn Forbes\forbebr01,SG,24,SAS,80,12,1517,209,497,0.421,89,228,0.39,120,269,0.446,0.51,48,72,0.667,12,98,110,80,28,2,37,108,555
2017,Evan Fournier\fournev01,SF,25,ORL,57,57,1837,368,802,0.459,127,335,0.379,241,467,0.516,0.538,150,173,0.867,23,157,180,165,47,16,95,138,1013
2017,De'Aaron Fox\foxde01,PG,20,SAC,73,60,2026,328,797,0.412,47,153,0.307,281,644,0.436,0.441,141,195,0.723,33,171,204,320,70,20,173,163,844
2017,Tim Frazier\fraziti01,PG,27,WAS,59,11,838,68,172,0.395,17,56,0.304,51,116,0.44,0.445,23,30,0.767,18,97,115,194,47,7,57,97,176
2017,Channing Frye\fryech01,C,34,TOT,53,1,695,104,212,0.491,39,115,0.339,65,97,0.67,0.583,17,19,0.895,12,123,135,38,18,13,21,69,264
2017,Channing Frye\fryech01,C,34,CLE,44,1,545,84,169,0.497,30,90,0.333,54,79,0.684,0.586,14,15,0.933,10,100,110,28,17,12,17,54,212
2017,Channing Frye\fryech01,C,34,LAL,9,0,150,20,43,0.465,9,25,0.36,11,18,0.611,0.57,3,4,0.75,2,23,25,10,1,1,4,15,52
2017,Markelle Fultz\fultzma01,SG,19,PHI,14,0,253,45,111,0.405,0,1,0,45,110,0.409,0.405,10,21,0.476,11,32,43,53,12,4,17,22,100
2017,Danilo Gallinari\gallida01,SF,29,LAC,21,21,671,102,256,0.398,36,111,0.324,66,145,0.455,0.469,81,87,0.931,9,92,101,41,12,10,26,30,321
2017,Langston Galloway\gallola01,SG,26,DET,58,2,863,126,340,0.371,75,218,0.344,51,122,0.418,0.481,33,41,0.805,13,79,92,58,35,5,18,39,360
2017,Marc Gasol\gasolma01,C,33,MEM,73,73,2408,434,1033,0.42,109,320,0.341,325,713,0.456,0.473,281,337,0.834,78,514,592,305,54,101,194,185,1258
2017,Pau Gasol\gasolpa01,C,37,SAS,77,63,1812,287,627,0.458,43,120,0.358,244,507,0.481,0.492,158,209,0.756,129,490,619,238,24,79,108,121,775
2017,Rudy Gay\gayru01,PF,31,SAS,57,6,1231,253,537,0.471,37,118,0.314,216,419,0.516,0.506,112,145,0.772,76,215,291,73,46,38,78,98,655
2017,Paul George\georgpa01,SF,27,OKC,79,79,2891,576,1340,0.43,244,609,0.401,332,731,0.454,0.521,338,411,0.822,72,375,447,263,161,39,212,233,1734
2017,Marcus Georges-Hunt\georgma01,SG,23,MIN,42,0,224,21,48,0.438,4,15,0.267,17,33,0.515,0.479,13,21,0.619,7,9,16,7,6,0,3,32,59
2017,Jonathan Gibson\gibsojo01,PG,30,BOS,4,0,40,14,23,0.609,6,12,0.5,8,11,0.727,0.739,0,0,,0,3,3,4,0,0,3,5,34
2017,Taj Gibson\gibsota01,PF,32,MIN,82,82,2726,425,737,0.577,7,35,0.2,418,702,0.595,0.581,142,185,0.768,194,390,584,99,62,59,89,218,999
2017,Manu Ginóbili\ginobma01,SG,40,SAS,65,0,1299,201,463,0.434,64,192,0.333,137,271,0.506,0.503,110,131,0.84,19,123,142,163,43,16,105,126,576
2017,Rudy Gobert\goberru01,C,25,UTA,56,56,1816,276,444,0.622,0,0,,276,444,0.622,0.622,204,299,0.682,165,436,601,80,44,129,107,153,756
2017,Aaron Gordon\gordoaa01,PF,22,ORL,58,57,1909,375,865,0.434,115,342,0.336,260,523,0.497,0.5,157,225,0.698,87,370,457,136,59,45,107,111,1022
2017,Eric Gordon\gordoer01,SG,29,HOU,69,30,2154,415,970,0.428,218,608,0.359,197,362,0.544,0.54,195,241,0.809,25,145,170,154,44,27,130,116,1243
2017,Marcin Gortat\gortama01,C,33,WAS,82,82,2075,290,560,0.518,0,0,,290,560,0.518,0.518,110,163,0.675,181,442,623,151,40,61,99,175,690
2017,Treveon Graham\grahatr01,SG,24,CHO,63,2,1050,96,221,0.434,40,97,0.412,56,124,0.452,0.525,41,59,0.695,42,79,121,59,33,2,27,109,273
2017,Jerami Grant\grantje01,PF,23,OKC,81,1,1647,244,456,0.535,32,110,0.291,212,346,0.613,0.57,162,240,0.675,86,233,319,57,31,77,54,155,682
2017,Jerian Grant\grantje02,PG,25,CHI,74,26,1686,209,503,0.416,61,187,0.326,148,316,0.468,0.476,140,188,0.745,31,141,172,342,63,8,89,132,619
2017,Josh Gray\grayjo01,PG,24,PHO,5,0,86,11,41,0.268,3,13,0.231,8,28,0.286,0.305,7,11,0.636,2,8,10,12,8,2,7,8,32
2017,Danny Green\greenda02,SG,30,SAS,70,60,1791,217,561,0.387,116,320,0.363,101,241,0.419,0.49,50,65,0.769,41,208,249,110,63,80,74,122,600
2017,Draymond Green\greendr01,PF,27,GSW,70,70,2287,281,619,0.454,77,256,0.301,204,363,0.562,0.516,134,173,0.775,75,460,535,508,95,91,202,185,773
2017,Gerald Green\greenge01,SG,32,HOU,41,2,929,168,413,0.407,110,298,0.369,58,115,0.504,0.54,51,60,0.85,15,118,133,25,24,15,31,87,497
2017,JaMychal Green\greenja01,PF,27,MEM,55,54,1542,223,488,0.457,43,127,0.339,180,361,0.499,0.501,80,111,0.721,147,317,464,79,32,25,76,153,569
2017,Jeff Green\greenje02,PF,31,CLE,78,13,1828,295,618,0.477,53,170,0.312,242,448,0.54,0.52,203,234,0.868,60,186,246,99,41,34,75,149,846
2017,Blake Griffin\griffbl01,PF,28,TOT,58,58,1970,436,996,0.438,111,322,0.345,325,674,0.482,0.493,259,330,0.785,73,355,428,334,41,18,165,139,1242
2017,Blake Griffin\griffbl01,PF,28,LAC,33,33,1139,255,578,0.441,64,187,0.342,191,391,0.488,0.497,172,219,0.785,46,216,262,179,30,9,99,78,746
2017,Blake Griffin\griffbl01,PF,28,DET,25,25,831,181,418,0.433,47,135,0.348,134,283,0.473,0.489,87,111,0.784,27,139,166,155,11,9,66,61,496
2017,Daniel Hamilton\hamilda02,SG,22,OKC,6,0,28,5,11,0.455,2,5,0.4,3,6,0.5,0.545,0,0,,0,5,5,8,1,0,2,2,12
2017,Tim Hardaway Jr.\hardati02,SG,25,NYK,57,54,1885,360,856,0.421,130,410,0.317,230,446,0.516,0.496,146,179,0.816,32,192,224,155,62,10,92,123,996
2017,James Harden\hardeja01,SG,28,HOU,72,72,2551,651,1449,0.449,265,722,0.367,386,727,0.531,0.541,624,727,0.858,41,348,389,630,126,50,315,169,2191
2017,Maurice Harkless\harklma01,SF,24,POR,59,36,1264,147,297,0.495,49,118,0.415,98,179,0.547,0.577,42,59,0.712,46,116,162,53,48,43,40,103,385
2017,Montrezl Harrell\harremo01,C,24,LAC,76,3,1293,348,548,0.635,1,7,0.143,347,541,0.641,0.636,139,222,0.626,103,203,306,74,36,52,68,143,836
2017,Devin Harris\harride01,PG,34,TOT,71,1,1340,187,454,0.412,79,227,0.348,108,227,0.476,0.499,142,170,0.835,12,115,127,152,47,12,76,158,595
2017,Devin Harris\harride01,PG,34,DAL,44,1,807,118,284,0.415,44,125,0.352,74,159,0.465,0.493,93,112,0.83,9,76,85,85,33,8,49,103,373
2017,Devin Harris\harride01,PG,34,DEN,27,0,533,69,170,0.406,35,102,0.343,34,68,0.5,0.509,49,58,0.845,3,39,42,67,14,4,27,55,222
2017,Gary Harris\harriga01,SG,23,DEN,67,65,2304,440,908,0.485,156,394,0.396,284,514,0.553,0.57,134,162,0.827,37,139,176,194,122,15,119,119,1170
2017,Joe Harris\harrijo01,SG,26,BRK,78,14,1975,305,621,0.491,150,358,0.419,155,263,0.589,0.612,86,104,0.827,51,209,260,128,35,20,91,153,846
2017,Tobias Harris\harrito02,PF,25,TOT,80,80,2668,562,1221,0.46,183,445,0.411,379,776,0.488,0.535,179,216,0.829,58,379,437,192,71,35,105,164,1486
2017,Tobias Harris\harrito02,PF,25,DET,48,48,1563,320,709,0.451,113,276,0.409,207,433,0.478,0.531,115,136,0.846,36,208,244,94,34,15,51,91,868
2017,Tobias Harris\harrito02,PF,25,LAC,32,32,1105,242,512,0.473,70,169,0.414,172,343,0.501,0.541,64,80,0.8,22,171,193,98,37,20,54,73,618
2017,Aaron Harrison\harriaa01,SG,23,DAL,9,3,233,19,69,0.275,9,43,0.209,10,26,0.385,0.341,13,17,0.765,4,20,24,11,9,2,3,27,60
2017,Andrew Harrison\harrian01,PG,23,MEM,56,46,1326,181,429,0.422,47,142,0.331,134,287,0.467,0.477,124,159,0.78,23,108,131,177,38,26,81,138,533
2017,Shaquille Harrison\harrish01,PG,24,PHO,23,2,384,59,124,0.476,6,26,0.231,53,98,0.541,0.5,28,38,0.737,9,52,61,55,26,7,22,42,152
2017,Josh Hart\hartjo01,SG,22,LAL,63,23,1461,176,375,0.469,78,197,0.396,98,178,0.551,0.573,66,94,0.702,42,221,263,80,47,16,47,107,496
2017,Udonis Haslem\hasleud01,C,37,MIA,14,0,72,3,15,0.2,1,8,0.125,2,7,0.286,0.233,1,2,0.5,3,7,10,5,0,2,2,3,8
2017,Nigel Hayes\hayesni01,SF,23,TOT,9,0,122,11,33,0.333,4,16,0.25,7,17,0.412,0.394,1,3,0.333,4,18,22,6,2,3,2,8,27
2017,Nigel Hayes\hayesni01,SF,23,LAL,2,0,11,1,3,0.333,0,2,0,1,1,1,0.333,1,1,1,0,0,0,2,0,0,0,0,3
2017,Nigel Hayes\hayesni01,SF,23,TOR,2,0,6,2,2,1,2,2,1,0,0,,1.5,0,0,,0,0,0,0,0,0,1,0,6
2017,Nigel Hayes\hayesni01,SF,23,SAC,5,0,105,8,28,0.286,2,12,0.167,6,16,0.375,0.321,0,2,0,4,18,22,4,2,3,1,8,18
2017,Gordon Hayward\haywago01,SF,27,BOS,1,1,5,1,2,0.5,0,1,0,1,1,1,0.5,0,0,,0,1,1,0,0,0,0,1,2
2017,Reggie Hearn\hearnre01,SG,26,DET,3,0,7,1,2,0.5,1,2,0.5,0,0,,0.75,0,0,,0,0,0,0,0,0,0,0,3
2017,Myke Henry\henrymy01,SF,25,MEM,20,0,378,41,109,0.376,19,58,0.328,22,51,0.431,0.463,6,10,0.6,10,28,38,22,31,6,19,28,107
2017,John Henson\hensojo01,C,27,MIL,76,69,1970,287,502,0.572,1,7,0.143,286,495,0.578,0.573,90,158,0.57,150,363,513,114,45,109,84,202,665
2017,Juan Hernangómez\hernaju01,PF,22,DEN,25,3,277,29,75,0.387,14,50,0.28,15,25,0.6,0.48,10,12,0.833,18,36,54,12,6,3,9,25,82
2017,Willy Hernangómez\hernawi01,C,23,TOT,48,1,495,91,164,0.555,5,12,0.417,86,152,0.566,0.57,59,90,0.656,61,122,183,33,18,16,35,64,246
2017,Willy Hernangómez\hernawi01,C,23,NYK,26,0,233,49,81,0.605,1,5,0.2,48,76,0.632,0.611,12,28,0.429,22,45,67,21,8,7,26,32,111
2017,Willy Hernangómez\hernawi01,C,23,CHO,22,1,262,42,83,0.506,4,7,0.571,38,76,0.5,0.53,47,62,0.758,39,77,116,12,10,9,9,32,135
2017,Mario Hezonja\hezonma01,SF,22,ORL,75,30,1657,273,617,0.442,90,267,0.337,183,350,0.523,0.515,86,105,0.819,41,240,281,106,81,31,86,134,722
2017,Isaiah Hicks\hicksis01,PF,23,NYK,18,0,240,33,72,0.458,2,9,0.222,31,63,0.492,0.472,12,18,0.667,10,31,41,16,2,4,16,45,80
2017,Buddy Hield\hieldbu01,SG,25,SAC,80,12,2024,416,933,0.446,176,408,0.431,240,525,0.457,0.54,71,81,0.877,55,252,307,155,85,22,124,148,1079
2017,Nenê\hilarne01,C,35,HOU,52,4,758,136,239,0.569,0,2,0,136,237,0.574,0.569,68,107,0.636,54,122,176,45,28,14,38,123,340
2017,George Hill\hillge01,PG,31,TOT,67,60,1812,236,513,0.46,85,205,0.415,151,308,0.49,0.543,110,140,0.786,42,139,181,186,61,27,88,128,667
2017,George Hill\hillge01,PG,31,SAC,43,36,1143,153,326,0.469,58,128,0.453,95,198,0.48,0.558,77,99,0.778,22,95,117,119,39,12,60,75,441
2017,George Hill\hillge01,PG,31,CLE,24,24,669,83,187,0.444,27,77,0.351,56,110,0.509,0.516,33,41,0.805,20,44,64,67,22,15,28,53,226
2017,Solomon Hill\hillso01,SF,26,NOP,12,1,187,11,41,0.268,4,21,0.19,7,20,0.35,0.317,3,6,0.5,9,27,36,22,7,1,9,22,29
2017,Darrun Hilliard\hillida01,SG,24,SAS,14,0,95,5,19,0.263,0,6,0,5,13,0.385,0.263,6,7,0.857,0,7,7,11,2,0,4,7,16
2017,Jrue Holiday\holidjr01,SG,27,NOP,81,81,2927,615,1244,0.494,120,356,0.337,495,888,0.557,0.543,187,238,0.786,62,303,365,486,123,64,213,201,1537
2017,Justin Holiday\holidju01,SG,28,CHI,72,72,2265,290,782,0.371,161,449,0.359,129,333,0.387,0.474,135,164,0.823,31,260,291,153,80,31,93,134,876
2017,John Holland\hollajo02,SF,29,CLE,24,0,174,17,59,0.288,11,36,0.306,6,23,0.261,0.381,9,13,0.692,6,18,24,5,7,2,8,10,54
2017,Rondae Hollis-Jefferson\holliro01,SF,23,BRK,68,59,1920,342,724,0.472,13,54,0.241,329,670,0.491,0.481,249,316,0.788,101,358,459,167,65,48,121,145,946
2017,Richaun Holmes\holmeri01,C,24,PHI,48,2,746,135,241,0.56,4,31,0.129,131,210,0.624,0.568,37,56,0.661,57,154,211,61,20,29,25,97,311
2017,Rodney Hood\hoodro01,SG,25,TOT,60,23,1616,322,751,0.429,127,333,0.381,195,418,0.467,0.513,111,129,0.86,22,143,165,95,45,12,70,105,882
2017,Rodney Hood\hoodro01,SG,25,UTA,39,12,1084,234,552,0.424,102,262,0.389,132,290,0.455,0.516,85,97,0.876,14,97,111,65,30,7,63,64,655
2017,Rodney Hood\hoodro01,SG,25,CLE,21,11,532,88,199,0.442,25,71,0.352,63,128,0.492,0.505,26,32,0.813,8,46,54,30,15,5,7,41,227
2017,Scotty Hopson\hopsosc01,SG,28,DAL,1,0,8,0,1,0,0,0,,0,1,0,0,1,2,0.5,0,0,0,1,0,0,1,0,1
2017,Al Horford\horfoal01,C,31,BOS,72,72,2277,368,753,0.489,97,226,0.429,271,527,0.514,0.553,94,120,0.783,103,427,530,339,43,78,132,138,927
2017,Danuel House\houseda01,SG,24,PHO,23,3,403,56,129,0.434,15,58,0.259,41,71,0.577,0.492,25,31,0.806,13,63,76,25,7,6,11,23,152
2017,Dwight Howard\howardw01,C,32,CHO,81,81,2463,506,911,0.555,1,7,0.143,505,904,0.559,0.556,334,582,0.574,255,757,1012,105,48,131,208,249,1347
2017,Josh Huestis\huestjo01,PF,26,OKC,69,10,982,60,182,0.33,33,115,0.287,27,67,0.403,0.42,6,20,0.3,42,119,161,20,15,43,26,82,159
2017,R.J. Hunter\hunterj01,SG,24,HOU,5,1,45,7,20,0.35,3,14,0.214,4,6,0.667,0.425,2,2,1,0,5,5,3,3,0,2,7,19
2017,Vince Hunter\huntevi01,PF,23,MEM,4,0,7,3,5,0.6,0,0,,3,5,0.6,0.6,0,0,,2,1,3,0,0,1,1,0,6
2017,Serge Ibaka\ibakase01,PF,28,TOR,76,76,2093,379,784,0.483,107,297,0.36,272,487,0.559,0.552,94,118,0.797,78,400,478,62,29,99,90,209,959
2017,Andre Iguodala\iguodan01,SF,34,GSW,64,7,1622,148,320,0.463,33,117,0.282,115,203,0.567,0.514,55,87,0.632,50,196,246,210,54,38,67,99,384
2017,Ersan İlyasova\ilyaser01,PF,30,TOT,69,43,1729,277,613,0.452,91,253,0.36,186,360,0.517,0.526,105,135,0.778,118,287,405,90,61,26,72,157,750
2017,Ersan İlyasova\ilyaser01,PF,30,ATL,46,40,1175,184,401,0.459,61,170,0.359,123,231,0.532,0.535,72,90,0.8,74,177,251,51,44,17,43,92,501
2017,Ersan İlyasova\ilyaser01,PF,30,PHI,23,3,554,93,212,0.439,30,83,0.361,63,129,0.488,0.509,33,45,0.733,44,110,154,39,17,9,29,65,249
2017,Joe Ingles\inglejo01,SF,30,UTA,82,81,2578,335,718,0.467,204,464,0.44,131,254,0.516,0.609,66,83,0.795,24,320,344,392,90,20,159,178,940
2017,Andre Ingram\ingraan01,SG,32,LAL,2,0,64,8,17,0.471,5,9,0.556,3,8,0.375,0.618,3,3,1,1,5,6,7,3,3,3,3,24
2017,Brandon Ingram\ingrabr01,SF,20,LAL,59,59,1975,358,761,0.47,41,105,0.39,317,656,0.483,0.497,192,282,0.681,57,257,314,230,45,43,149,163,949
2017,Kyrie Irving\irvinky01,PG,25,BOS,60,60,1931,534,1087,0.491,166,407,0.408,368,680,0.541,0.568,232,261,0.889,33,194,227,306,65,17,140,122,1466
2017,Jonathan Isaac\isaacjo01,PF,20,ORL,27,10,536,55,145,0.379,16,46,0.348,39,99,0.394,0.434,19,25,0.76,16,83,99,18,33,30,27,48,145
2017,Wesley Iwundu\iwundwe01,SF,23,ORL,62,12,1020,93,218,0.427,9,46,0.196,84,172,0.488,0.447,34,47,0.723,36,101,137,57,33,12,30,81,229
2017,Jarrett Jack\jackja01,PG,34,NYK,62,56,1548,189,443,0.427,25,86,0.291,164,357,0.459,0.455,63,75,0.84,22,169,191,348,35,4,115,98,466
2017,Aaron Jackson\jacksaa01,PG,31,HOU,1,0,35,3,9,0.333,1,4,0.25,2,5,0.4,0.389,1,2,0.5,2,1,3,1,0,0,1,4,8
2017,Demetrius Jackson\jacksde01,PG,23,TOT,15,0,80,7,18,0.389,1,7,0.143,6,11,0.545,0.417,1,2,0.5,5,7,12,9,5,1,10,7,16
2017,Demetrius Jackson\jacksde01,PG,23,HOU,12,0,63,4,14,0.286,0,6,0,4,8,0.5,0.286,0,0,,4,7,11,5,4,1,9,6,8
2017,Demetrius Jackson\jacksde01,PG,23,PHI,3,0,17,3,4,0.75,1,1,1,2,3,0.667,0.875,1,2,0.5,1,0,1,4,1,0,1,1,8
2017,Josh Jackson\jacksjo02,SF,20,PHO,77,35,1959,389,932,0.417,57,217,0.263,332,715,0.464,0.448,177,279,0.634,95,256,351,119,80,35,146,218,1012
2017,Justin Jackson\jacksju01,SF,22,SAC,68,41,1506,185,419,0.442,57,185,0.308,128,234,0.547,0.51,26,36,0.722,27,160,187,74,28,13,40,81,453
2017,Reggie Jackson\jacksre01,PG,27,DET,45,45,1201,246,577,0.426,52,169,0.308,194,408,0.475,0.471,112,134,0.836,29,96,125,238,27,4,99,87,656
2017,LeBron James\jamesle01,PF,33,CLE,82,82,3026,857,1580,0.542,149,406,0.367,708,1174,0.603,0.59,388,531,0.731,97,612,709,747,116,71,347,136,2251
2017,Mike James\jamesmi02,PG,27,TOT,36,10,687,123,321,0.383,26,98,0.265,97,223,0.435,0.424,64,84,0.762,13,77,90,126,28,7,49,48,336
2017,Mike James\jamesmi02,PG,27,PHO,32,10,669,121,312,0.388,26,97,0.268,95,215,0.442,0.429,64,84,0.762,12,77,89,120,27,7,48,45,332
2017,Mike James\jamesmi02,PG,27,NOP,4,0,18,2,9,0.222,0,1,0,2,8,0.25,0.222,0,0,,1,0,1,6,1,0,1,3,4
2017,Al Jefferson\jeffeal01,C,33,IND,36,1,484,111,208,0.534,0,3,0,111,205,0.541,0.534,30,36,0.833,30,113,143,30,16,23,21,66,252
2017,Richard Jefferson\jefferi01,SF,37,DEN,20,0,163,12,27,0.444,2,7,0.286,10,20,0.5,0.481,4,7,0.571,2,15,17,15,2,1,5,11,30
2017,Brandon Jennings\jennibr01,PG,28,MIL,14,0,205,27,72,0.375,9,33,0.273,18,39,0.462,0.438,10,10,1,5,26,31,44,6,4,18,11,73
2017,Jonas Jerebko\jerebjo01,PF,30,UTA,74,19,1134,159,341,0.466,65,157,0.414,94,184,0.511,0.562,46,57,0.807,53,193,246,42,24,12,27,127,429
2017,Amir Johnson\johnsam01,C,30,PHI,74,18,1171,140,260,0.538,10,32,0.313,130,228,0.57,0.558,52,85,0.612,123,207,330,118,45,44,55,192,342
2017,Brice Johnson\johnsbr02,PF,23,TOT,18,0,98,20,42,0.476,0,1,0,20,41,0.488,0.476,3,5,0.6,9,22,31,2,9,6,5,13,43
2017,Brice Johnson\johnsbr02,PF,23,LAC,9,0,38,7,11,0.636,0,1,0,7,10,0.7,0.636,2,2,1,2,11,13,1,6,2,4,7,16
2017,Brice Johnson\johnsbr02,PF,23,MEM,9,0,60,13,31,0.419,0,0,,13,31,0.419,0.419,1,3,0.333,7,11,18,1,3,4,1,6,27
2017,Dakari Johnson\johnsda04,C,22,OKC,31,6,161,22,39,0.564,0,0,,22,39,0.564,0.564,11,20,0.55,16,18,34,8,6,8,3,27,55
2017,James Johnson\johnsja01,PF,30,MIA,73,41,1943,309,614,0.503,57,185,0.308,252,429,0.587,0.55,113,162,0.698,61,297,358,280,70,51,141,192,788
2017,Joe Johnson\johnsjo02,SF,36,TOT,55,4,1205,146,360,0.406,40,145,0.276,106,215,0.493,0.461,40,45,0.889,14,158,172,83,18,7,49,67,372
2017,Joe Johnson\johnsjo02,SF,36,UTA,32,3,700,95,226,0.42,23,84,0.274,72,142,0.507,0.471,20,24,0.833,12,95,107,45,12,6,31,32,233
2017,Joe Johnson\johnsjo02,SF,36,HOU,23,1,505,51,134,0.381,17,61,0.279,34,73,0.466,0.444,20,21,0.952,2,63,65,38,6,1,18,35,139
2017,Omari Johnson\johnsom01,PF,28,MEM,4,0,75,9,21,0.429,4,12,0.333,5,9,0.556,0.524,0,0,,4,7,11,7,2,0,3,6,22
2017,Stanley Johnson\johnsst04,SF,21,DET,69,50,1894,210,560,0.375,67,234,0.286,143,326,0.439,0.435,112,145,0.772,33,219,252,112,95,14,77,169,599
2017,Tyler Johnson\johnsty01,PG,25,MIA,72,39,2052,309,711,0.435,119,324,0.367,190,387,0.491,0.518,106,129,0.822,34,214,248,165,60,34,81,148,843
2017,Wesley Johnson\johnswe01,SF,30,LAC,74,40,1486,150,368,0.408,60,177,0.339,90,191,0.471,0.489,43,58,0.741,29,187,216,61,76,62,55,146,403
2017,Nikola Jokić\jokicni01,C,22,DEN,75,73,2443,504,1010,0.499,111,280,0.396,393,730,0.538,0.554,266,313,0.85,195,608,803,458,90,61,210,212,1385
2017,Damian Jones\jonesda03,C,22,GSW,15,0,89,11,22,0.5,0,0,,11,22,0.5,0.5,3,5,0.6,5,9,14,2,1,3,4,14,25
2017,Derrick Jones Jr.\jonesde02,SF,20,TOT,20,8,245,21,53,0.396,3,18,0.167,18,35,0.514,0.425,16,24,0.667,21,17,38,9,4,13,7,24,61
2017,Derrick Jones Jr.\jonesde02,SF,20,PHO,6,0,33,2,4,0.5,0,2,0,2,2,1,0.5,5,6,0.833,2,2,4,3,1,4,1,2,9
2017,Derrick Jones Jr.\jonesde02,SF,20,MIA,14,8,212,19,49,0.388,3,16,0.188,16,33,0.485,0.418,11,18,0.611,19,15,34,6,3,9,6,22,52
2017,Jalen Jones\jonesja04,SF,24,TOT,16,0,181,26,68,0.382,10,26,0.385,16,42,0.381,0.456,12,19,0.632,13,25,38,4,5,1,7,22,74
2017,Jalen Jones\jonesja04,SF,24,NOP,4,0,19,1,4,0.25,1,1,1,0,3,0,0.375,2,2,1,0,3,3,0,0,0,0,2,5
2017,Jalen Jones\jonesja04,SF,24,DAL,12,0,162,25,64,0.391,9,25,0.36,16,39,0.41,0.461,10,17,0.588,13,22,35,4,5,1,7,20,69
2017,Tyus Jones\jonesty01,PG,21,MIN,82,11,1467,150,328,0.457,45,129,0.349,105,199,0.528,0.526,71,81,0.877,16,116,132,232,95,6,59,110,416
2017,DeAndre Jordan\jordade01,C,29,LAC,77,77,2424,373,578,0.645,0,0,,373,578,0.645,0.645,181,312,0.58,329,842,1171,117,39,71,137,203,927
2017,Cory Joseph\josepco01,PG,26,IND,82,17,2210,256,604,0.424,67,190,0.353,189,414,0.457,0.479,70,94,0.745,39,224,263,260,80,18,87,141,649
2017,Frank Kaminsky\kaminfr01,PF,24,CHO,79,4,1835,307,716,0.429,104,274,0.38,203,442,0.459,0.501,155,194,0.799,46,242,288,129,36,19,66,95,873
2017,Enes Kanter\kanteen01,C,25,NYK,71,71,1830,422,713,0.592,0,2,0,422,711,0.594,0.592,156,184,0.848,273,507,780,105,36,37,122,187,1000
2017,Luke Kennard\kennalu01,SG,21,DET,73,9,1463,206,465,0.443,81,195,0.415,125,270,0.463,0.53,65,76,0.855,21,155,176,124,44,13,69,86,558
2017,Michael Kidd-Gilchrist\kiddgmi01,SF,24,CHO,74,74,1850,282,560,0.504,0,2,0,282,558,0.505,0.504,117,171,0.684,84,218,302,71,51,32,53,143,681
2017,Sean Kilpatrick\kilpase01,SG,28,TOT,52,1,640,110,294,0.374,46,144,0.319,64,150,0.427,0.452,64,72,0.889,5,82,87,46,13,5,38,33,330
2017,Sean Kilpatrick\kilpase01,SG,28,BRK,16,0,183,25,87,0.287,11,43,0.256,14,44,0.318,0.351,18,19,0.947,1,34,35,15,2,1,16,8,79
2017,Sean Kilpatrick\kilpase01,SG,28,MIL,23,0,205,31,82,0.378,13,46,0.283,18,36,0.5,0.457,18,19,0.947,1,24,25,15,5,1,9,15,93
2017,Sean Kilpatrick\kilpase01,SG,28,LAC,4,0,38,7,18,0.389,3,7,0.429,4,11,0.364,0.472,2,2,1,0,2,2,3,0,0,1,2,19
2017,Sean Kilpatrick\kilpase01,SG,28,CHI,9,1,214,47,107,0.439,19,48,0.396,28,59,0.475,0.528,26,32,0.813,3,22,25,13,6,3,12,8,139
2017,Maxi Kleber\klebima01,PF,26,DAL,72,36,1206,151,309,0.489,40,128,0.313,111,181,0.613,0.553,44,59,0.746,71,163,234,51,26,47,30,114,386
2017,Furkan Korkmaz\korkmfu01,SG,20,PHI,14,0,80,8,28,0.286,5,17,0.294,3,11,0.273,0.375,2,4,0.5,2,9,11,4,2,1,2,12,23
2017,Luke Kornet\kornelu01,PF,22,NYK,20,1,326,49,125,0.392,28,79,0.354,21,46,0.457,0.504,8,11,0.727,11,53,64,26,6,16,12,28,134
2017,Kyle Korver\korveky01,SG,36,CLE,73,4,1574,222,484,0.459,164,376,0.436,58,108,0.537,0.628,64,72,0.889,9,156,165,88,31,27,55,130,672
2017,Kosta Koufos\koufoko01,C,28,SAC,71,13,1391,222,389,0.571,0,0,,222,389,0.571,0.571,33,74,0.446,149,323,472,87,47,32,49,146,477
2017,Kyle Kuzma\kuzmaky01,PF,22,LAL,77,37,2401,468,1039,0.45,159,434,0.366,309,605,0.511,0.527,147,208,0.707,88,395,483,141,49,34,140,160,1242
2017,Mindaugas Kuzminskas\kuzmimi01,SF,28,NYK,1,0,2,0,2,0,0,0,,0,2,0,0,0,0,,0,0,0,0,0,0,0,0,0
2017,Skal Labissière\labissk01,PF,21,SAC,60,28,1240,205,458,0.448,18,51,0.353,187,407,0.459,0.467,95,118,0.805,99,189,288,72,25,49,73,132,523
2017,Jeremy Lamb\lambje01,SG,25,CHO,80,18,1967,380,832,0.457,94,254,0.37,286,578,0.495,0.513,179,208,0.861,49,275,324,186,61,32,93,138,1033
2017,Shane Larkin\larkish01,PG,25,BOS,54,2,775,84,219,0.384,31,86,0.36,53,133,0.398,0.454,32,37,0.865,15,77,92,98,29,2,33,58,231
2017,Joffrey Lauvergne\lauvejo01,C,26,SAS,55,1,534,98,190,0.516,0,5,0,98,185,0.53,0.516,30,47,0.638,63,108,171,41,9,3,33,45,226
2017,Zach LaVine\lavinza01,SG,22,CHI,24,24,656,136,355,0.383,42,123,0.341,94,232,0.405,0.442,87,107,0.813,9,85,94,72,24,4,43,55,401
2017,Jake Layman\laymaja01,SF,23,POR,35,1,160,14,47,0.298,4,20,0.2,10,27,0.37,0.34,2,3,0.667,4,12,16,11,6,4,5,13,34
2017,T.J. Leaf\leaftj01,PF,20,IND,53,0,459,64,136,0.471,18,42,0.429,46,94,0.489,0.537,10,16,0.625,29,53,82,9,5,4,10,45,156
2017,Courtney Lee\leeco01,SG,32,NYK,76,69,2310,343,755,0.454,113,278,0.406,230,477,0.482,0.529,114,124,0.919,30,194,224,180,80,17,84,109,913
2017,Damion Lee\leeda03,SG,25,ATL,15,11,404,62,152,0.408,15,60,0.25,47,92,0.511,0.457,22,29,0.759,11,60,71,29,19,1,14,25,161
2017,Walt Lemon Jr.\lemonwa01,PG,25,NOP,5,0,35,7,16,0.438,1,1,1,6,15,0.4,0.469,2,3,0.667,0,2,2,5,0,1,4,5,17
2017,Alex Len\lenal01,C,24,PHO,69,13,1395,214,378,0.566,1,3,0.333,213,375,0.568,0.567,158,231,0.684,175,343,518,82,27,61,78,158,587
2017,Kawhi Leonard\leonaka01,SF,26,SAS,9,9,210,52,111,0.468,11,35,0.314,41,76,0.539,0.518,31,38,0.816,6,36,42,21,18,9,16,9,146
2017,Meyers Leonard\leoname01,C,25,POR,33,2,254,46,78,0.59,11,26,0.423,35,52,0.673,0.66,9,11,0.818,12,58,70,17,7,0,10,36,112
2017,Jon Leuer\leuerjo01,PF,28,DET,8,0,136,15,36,0.417,0,3,0,15,33,0.455,0.417,13,15,0.867,7,25,32,5,1,3,7,16,43
2017,Caris LeVert\leverca01,SF,23,BRK,71,10,1864,320,735,0.435,85,245,0.347,235,490,0.48,0.493,133,187,0.711,53,207,260,299,82,22,153,159,858
2017,DeAndre Liggins\liggide01,SG,29,TOT,58,4,724,40,106,0.377,19,53,0.358,21,53,0.396,0.467,2,5,0.4,7,68,75,48,37,14,20,81,101
2017,DeAndre Liggins\liggide01,SG,29,MIL,31,1,480,22,65,0.338,11,36,0.306,11,29,0.379,0.423,2,5,0.4,5,44,49,27,27,10,13,61,57
2017,DeAndre Liggins\liggide01,SG,29,NOP,27,3,244,18,41,0.439,8,17,0.471,10,24,0.417,0.537,0,0,,2,24,26,21,10,4,7,20,44
2017,Damian Lillard\lillada01,PG,27,POR,73,73,2670,621,1415,0.439,227,629,0.361,394,786,0.501,0.519,493,538,0.916,62,263,325,481,77,27,206,117,1962
2017,Jeremy Lin\linje01,PG,29,BRK,1,1,25,5,12,0.417,1,2,0.5,4,10,0.4,0.458,7,7,1,0,0,0,4,0,0,3,3,18
2017,Shaun Livingston\livinsh01,PG,32,GSW,71,7,1129,172,343,0.501,0,5,0,172,338,0.509,0.501,50,61,0.82,32,99,131,140,35,21,58,117,394
2017,Kevon Looney\looneke01,C,21,GSW,66,4,910,112,193,0.58,1,5,0.2,111,188,0.59,0.583,42,77,0.545,83,132,215,42,34,56,31,106,267
2017,Brook Lopez\lopezbr01,C,29,LAL,74,72,1735,369,793,0.465,112,325,0.345,257,468,0.549,0.536,111,158,0.703,74,220,294,126,30,98,98,195,961
2017,Robin Lopez\lopezro01,C,29,CHI,64,64,1690,342,645,0.53,4,14,0.286,338,631,0.536,0.533,68,90,0.756,134,156,290,124,14,53,107,109,756
2017,Kevin Love\loveke01,C,29,CLE,59,59,1651,334,729,0.458,137,330,0.415,197,399,0.494,0.552,234,266,0.88,101,445,546,103,43,24,90,120,1039
2017,Kyle Lowry\lowryky01,PG,31,TOR,78,78,2510,403,944,0.427,238,596,0.399,165,348,0.474,0.553,223,261,0.854,66,368,434,537,85,19,183,192,1267
2017,Timothé Luwawu-Cabarrot\luwawti01,SF,22,PHI,52,7,807,100,267,0.375,53,158,0.335,47,109,0.431,0.474,46,58,0.793,14,58,72,54,12,5,38,97,299
2017,Tyler Lydon\lydonty01,PF,21,DEN,1,0,2,0,0,,0,0,,0,0,,,0,0,,0,0,0,0,0,0,0,0,0
2017,Trey Lyles\lylestr01,PF,22,DEN,73,2,1391,270,550,0.491,83,218,0.381,187,332,0.563,0.566,101,143,0.706,55,292,347,91,30,34,61,111,724
2017,Shelvin Mack\macksh01,PG,27,ORL,69,3,1365,178,414,0.43,48,139,0.345,130,275,0.473,0.488,69,97,0.711,23,143,166,272,54,8,89,91,473
2017,Josh Magette\magetjo01,PG,28,ATL,18,0,216,15,46,0.326,8,22,0.364,7,24,0.292,0.413,8,8,1,2,17,19,57,8,1,9,16,46
2017,Ian Mahinmi\mahinia01,C,31,WAS,77,0,1145,138,248,0.556,0,2,0,138,246,0.561,0.556,90,128,0.703,135,177,312,53,38,42,100,230,366
2017,Thon Maker\makerth01,C,20,MIL,74,12,1238,130,316,0.411,31,104,0.298,99,212,0.467,0.46,65,93,0.699,75,150,225,46,38,53,44,162,356
2017,Boban Marjanović\marjabo01,C,29,TOT,39,1,337,79,148,0.534,0,0,,79,148,0.534,0.534,77,97,0.794,48,96,144,22,10,11,36,51,235
2017,Boban Marjanović\marjabo01,C,29,DET,19,1,171,41,79,0.519,0,0,,41,79,0.519,0.519,36,45,0.8,15,42,57,14,4,6,22,28,118
2017,Boban Marjanović\marjabo01,C,29,LAC,20,0,166,38,69,0.551,0,0,,38,69,0.551,0.551,41,52,0.788,33,54,87,8,6,5,14,23,117
2017,Lauri Markkanen\markkla01,PF,20,CHI,68,68,2020,374,862,0.434,145,401,0.362,229,461,0.497,0.518,140,166,0.843,79,429,508,79,39,40,83,103,1033
2017,Jarell Martin\martija01,PF,23,MEM,73,36,1661,221,496,0.446,34,98,0.347,187,398,0.47,0.48,89,116,0.767,97,221,318,73,39,49,86,211,565
2017,Frank Mason III\masonfr01,PG,23,SAC,52,2,984,144,380,0.379,31,86,0.36,113,294,0.384,0.42,94,115,0.817,30,100,130,147,34,10,65,72,413
2017,Mangok Mathiang\mathima01,C,25,CHO,4,0,20,4,7,0.571,0,0,,4,7,0.571,0.571,0,1,0,3,7,10,0,1,0,0,5,8
2017,Wesley Matthews\matthwe02,SF,31,DAL,63,62,2131,283,697,0.406,153,402,0.381,130,295,0.441,0.516,83,101,0.822,28,170,198,172,76,16,83,140,802
2017,Luc Mbah a Moute\mbahalu01,PF,31,HOU,61,15,1564,166,345,0.481,63,173,0.364,103,172,0.599,0.572,65,95,0.684,22,164,186,55,72,25,68,100,460
2017,James Michael McAdoo\mcadoja01,PF,25,PHI,3,0,18,2,7,0.286,2,7,0.286,0,0,,0.429,2,2,1,0,2,2,0,0,1,1,1,8
2017,Patrick McCaw\mccawpa01,SG,22,GSW,57,10,961,92,225,0.409,19,80,0.238,73,145,0.503,0.451,26,34,0.765,16,66,82,81,43,10,41,67,229
2017,CJ McCollum\mccolcj01,SG,26,POR,81,81,2923,667,1505,0.443,189,476,0.397,478,1029,0.465,0.506,209,250,0.836,53,268,321,272,77,35,151,168,1732
2017,T.J. McConnell\mccontj01,PG,25,PHI,76,1,1706,210,421,0.499,27,62,0.435,183,359,0.51,0.531,31,39,0.795,37,189,226,303,92,13,112,122,478
2017,Erik McCree\mccreer01,SF,24,UTA,4,0,8,0,2,0,0,1,0,0,1,0,0,0,0,,0,1,1,0,1,0,1,0,0
2017,Chris McCullough\mcculch01,PF,22,WAS,19,0,90,18,42,0.429,1,8,0.125,17,34,0.5,0.44,9,14,0.643,7,18,25,4,0,5,2,8,46
2017,Doug McDermott\mcderdo01,SF,26,TOT,81,4,1768,237,508,0.467,92,216,0.426,145,292,0.497,0.557,64,81,0.79,40,160,200,79,19,16,56,122,630
2017,Doug McDermott\mcderdo01,SF,26,NYK,55,1,1172,151,328,0.46,53,137,0.387,98,191,0.513,0.541,40,53,0.755,33,101,134,50,10,12,34,73,395
2017,Doug McDermott\mcderdo01,SF,26,DAL,26,3,596,86,180,0.478,39,79,0.494,47,101,0.465,0.586,24,28,0.857,7,59,66,29,9,4,22,49,235
2017,JaVale McGee\mcgeeja01,C,30,GSW,65,17,615,136,219,0.621,0,6,0,136,213,0.638,0.621,38,52,0.731,59,110,169,33,21,57,27,91,310
2017,Rodney McGruder\mcgruro01,SG,26,MIA,18,2,299,36,73,0.493,15,35,0.429,21,38,0.553,0.596,4,8,0.5,11,21,32,17,8,3,4,21,91
2017,Trey McKinney-Jones\mckintr01,SG,27,IND,1,0,1,0,0,,0,0,,0,0,,,0,0,,0,0,0,0,0,0,0,0,0
2017,Alfonzo McKinnie\mckinal01,SF,25,TOR,14,0,53,8,15,0.533,3,9,0.333,5,6,0.833,0.633,2,3,0.667,1,6,7,1,1,1,3,8,21
2017,Ben McLemore\mclembe01,SG,24,MEM,56,17,1091,157,373,0.421,55,159,0.346,102,214,0.477,0.495,53,64,0.828,34,105,139,51,38,15,61,139,422
2017,Josh McRoberts\mcrobjo01,PF,30,DAL,2,0,6,0,1,0,0,1,0,0,0,,0,0,0,,0,0,0,0,0,0,0,2,0
2017,Jodie Meeks\meeksjo01,SG,30,WAS,77,0,1119,157,393,0.399,72,210,0.343,85,183,0.464,0.491,101,117,0.863,15,111,126,70,29,4,37,55,487
2017,Salah Mejri\mejrisa01,C,31,DAL,61,1,729,88,137,0.642,0,3,0,88,134,0.657,0.642,38,66,0.576,85,161,246,35,22,67,39,121,214
2017,Jordan Mickey\mickejo01,PF,23,MIA,23,3,284,39,82,0.476,2,16,0.125,37,66,0.561,0.488,13,19,0.684,18,63,81,9,6,10,18,36,93
2017,Khris Middleton\middlkh01,SF,26,MIL,82,82,2982,593,1272,0.466,146,407,0.359,447,865,0.517,0.524,320,362,0.884,45,384,429,328,119,21,191,270,1652
2017,C.J. Miles\milescj01,SF,30,TOR,70,3,1337,227,599,0.379,164,454,0.361,63,145,0.434,0.516,81,97,0.835,18,134,152,55,37,21,39,134,699
2017,Darius Miller\milleda01,SF,27,NOP,82,3,1944,216,487,0.444,147,358,0.411,69,129,0.535,0.594,58,67,0.866,18,146,164,111,28,17,58,160,637
2017,Malcolm Miller\millema01,SF,24,TOR,15,4,126,13,28,0.464,8,21,0.381,5,7,0.714,0.607,4,4,1,4,11,15,3,1,2,5,10,38
2017,Patty Mills\millspa02,PG,29,SAS,82,36,2107,280,682,0.411,154,414,0.372,126,268,0.47,0.523,105,118,0.89,26,128,154,229,55,11,106,128,819
2017,Paul Millsap\millspa01,PF,32,DEN,38,37,1143,202,435,0.464,39,113,0.345,163,322,0.506,0.509,112,161,0.696,65,180,245,105,39,44,73,99,555
2017,Nikola Mirotić\mirotni01,PF,26,TOT,55,14,1494,306,684,0.447,135,358,0.377,171,326,0.525,0.546,112,137,0.818,59,346,405,80,44,39,62,108,859
2017,Nikola Mirotić\mirotni01,PF,26,CHI,25,3,622,143,302,0.474,69,161,0.429,74,141,0.525,0.588,65,79,0.823,18,141,159,39,15,13,31,45,420
2017,Nikola Mirotić\mirotni01,PF,26,NOP,30,11,872,163,382,0.427,66,197,0.335,97,185,0.524,0.513,47,58,0.81,41,205,246,41,29,26,31,63,439
2017,Donovan Mitchell\mitchdo01,SG,21,UTA,79,71,2638,595,1362,0.437,187,550,0.34,408,812,0.502,0.506,239,297,0.805,52,244,296,291,118,27,215,213,1616
2017,Naz Mitrou-Long\mitrona01,SG,24,UTA,1,0,1,1,1,1,1,1,1,0,0,,1.5,0,0,,0,0,0,0,0,0,0,0,3
2017,Malik Monk\monkma01,SG,19,CHO,63,0,854,153,425,0.36,83,243,0.342,70,182,0.385,0.458,32,38,0.842,8,58,66,91,20,9,49,60,421
2017,Greg Monroe\monrogr01,C,27,TOT,51,14,1040,218,386,0.565,0,0,,218,386,0.565,0.565,88,119,0.739,109,241,350,114,44,23,94,95,524
2017,Greg Monroe\monrogr01,C,27,MIL,5,0,79,16,33,0.485,0,0,,16,33,0.485,0.485,2,4,0.5,6,19,25,5,0,0,6,7,34
2017,Greg Monroe\monrogr01,C,27,PHO,20,14,465,97,155,0.626,0,0,,97,155,0.626,0.626,31,46,0.674,50,110,160,50,16,6,40,40,225
2017,Greg Monroe\monrogr01,C,27,BOS,26,0,496,105,198,0.53,0,0,,105,198,0.53,0.53,55,69,0.797,53,112,165,59,28,17,48,48,265
2017,Luis Montero\montelu01,SG,24,DET,2,0,8,0,1,0,0,0,,0,1,0,0,0,0,,0,2,2,0,0,0,2,0,0
2017,Ben Moore\moorebe01,PF,22,IND,2,0,9,0,0,,0,0,,0,0,,,0,0,,0,1,1,1,0,0,0,4,0
2017,E'Twaun Moore\mooreet01,SG,28,NOP,82,80,2586,423,832,0.508,128,301,0.425,295,531,0.556,0.585,48,68,0.706,57,181,238,187,79,12,102,182,1022
2017,Eric Moreland\moreler01,PF,26,DET,67,3,805,66,122,0.541,0,0,,66,122,0.541,0.541,11,29,0.379,81,197,278,78,31,51,42,116,143
2017,Jaylen Morris\morrija01,SG,22,ATL,6,0,98,13,32,0.406,2,10,0.2,11,22,0.5,0.438,0,0,,2,14,16,7,2,1,6,2,28
2017,Marcus Morris\morrima03,PF,28,BOS,54,21,1447,262,611,0.429,86,234,0.368,176,377,0.467,0.499,124,154,0.805,43,246,289,72,35,12,65,100,734
2017,Markieff Morris\morrima02,PF,28,WAS,73,73,1968,330,687,0.48,76,207,0.367,254,480,0.529,0.536,105,128,0.82,75,334,409,142,56,38,127,216,841
2017,Monte Morris\morrimo01,PG,22,DEN,3,0,25,4,6,0.667,0,1,0,4,5,0.8,0.667,2,2,1,0,2,2,7,3,0,1,1,10
2017,Johnathan Motley\motlejo01,PF,22,DAL,11,4,176,40,75,0.533,1,6,0.167,39,69,0.565,0.54,15,28,0.536,14,35,49,7,3,2,9,18,96
2017,Timofey Mozgov\mozgoti01,C,31,BRK,31,13,359,52,93,0.559,4,18,0.222,48,75,0.64,0.581,23,30,0.767,32,66,98,11,5,13,33,39,131
2017,Emmanuel Mudiay\mudiaem01,PG,21,TOT,64,14,1245,204,526,0.388,47,148,0.318,157,378,0.415,0.433,98,129,0.76,26,126,152,206,41,11,113,80,553
2017,Emmanuel Mudiay\mudiaem01,PG,21,DEN,42,0,752,129,322,0.401,38,102,0.373,91,220,0.414,0.46,63,78,0.808,16,78,94,121,21,4,72,47,359
2017,Emmanuel Mudiay\mudiaem01,PG,21,NYK,22,14,493,75,204,0.368,9,46,0.196,66,158,0.418,0.39,35,51,0.686,10,48,58,85,20,7,41,33,194
2017,Shabazz Muhammad\muhamsh01,SF-SG,25,TOT,43,2,418,84,188,0.447,7,27,0.259,77,161,0.478,0.465,39,50,0.78,23,53,76,14,9,3,6,30,214
2017,Shabazz Muhammad\muhamsh01,SF,25,MIN,32,2,301,47,121,0.388,4,19,0.211,43,102,0.422,0.405,22,31,0.71,15,30,45,7,5,2,5,23,120
2017,Shabazz Muhammad\muhamsh01,SG,25,MIL,11,0,117,37,67,0.552,3,8,0.375,34,59,0.576,0.575,17,19,0.895,8,23,31,7,4,1,1,7,94
2017,Xavier Munford\munfoxa02,SG,25,MIL,6,0,21,1,6,0.167,0,2,0,1,4,0.25,0.167,1,2,0.5,1,0,1,4,1,0,2,4,3
2017,Dejounte Murray\murrade01,PG,21,SAS,81,48,1743,270,609,0.443,9,34,0.265,261,575,0.454,0.451,105,148,0.709,110,349,459,231,97,31,134,151,654
2017,Jamal Murray\murraja01,PG,20,DEN,81,80,2565,479,1062,0.451,165,436,0.378,314,626,0.502,0.529,229,253,0.905,82,215,297,274,79,28,172,173,1352
2017,Mike Muscala\muscami01,C,26,ATL,53,7,1060,143,312,0.458,62,167,0.371,81,145,0.559,0.558,57,62,0.919,56,174,230,51,31,27,42,80,405
2017,Abdel Nader\naderab01,SF,24,BOS,48,1,522,50,149,0.336,23,65,0.354,27,84,0.321,0.413,23,39,0.59,13,58,71,26,15,10,34,45,146
2017,Larry Nance Jr.\nancela02,C,25,TOT,66,27,1421,240,413,0.581,2,12,0.167,238,401,0.594,0.584,91,137,0.664,161,291,452,82,88,38,51,172,573
2017,Larry Nance Jr.\nancela02,C,25,LAL,42,17,922,152,253,0.601,1,4,0.25,151,249,0.606,0.603,55,87,0.632,108,176,284,57,59,20,41,113,360
2017,Larry Nance Jr.\nancela02,C,25,CLE,24,10,499,88,160,0.55,1,8,0.125,87,152,0.572,0.553,36,50,0.72,53,115,168,25,29,18,10,59,213
2017,Shabazz Napier\napiesh01,PG,26,POR,74,10,1535,223,531,0.42,82,218,0.376,141,313,0.45,0.497,116,138,0.841,26,144,170,150,81,14,90,84,644
2017,Jameer Nelson\nelsoja01,PG,35,TOT,50,0,1013,95,244,0.389,41,124,0.331,54,120,0.45,0.473,16,20,0.8,13,91,104,179,27,4,67,81,247
2017,Jameer Nelson\nelsoja01,PG,35,NOP,43,0,897,84,205,0.41,40,110,0.364,44,95,0.463,0.507,13,17,0.765,11,85,96,156,23,3,56,67,221
2017,Jameer Nelson\nelsoja01,PG,35,DET,7,0,116,11,39,0.282,1,14,0.071,10,25,0.4,0.295,3,3,1,2,6,8,23,4,1,11,14,26
2017,Raul Neto\netora01,PG,25,UTA,41,0,498,69,151,0.457,19,47,0.404,50,104,0.481,0.52,26,35,0.743,7,42,49,75,13,4,36,38,183
2017,Georges Niang\niangge01,PF,24,UTA,9,0,32,4,11,0.364,0,4,0,4,7,0.571,0.364,1,2,0.5,3,6,9,3,2,0,3,1,9
2017,Joakim Noah\noahjo01,C,32,NYK,7,0,40,5,10,0.5,0,0,,5,10,0.5,0.5,2,4,0.5,6,8,14,4,2,2,4,5,12
2017,Nerlens Noel\noelne01,C,23,DAL,30,6,472,55,105,0.524,0,1,0,55,104,0.529,0.524,21,28,0.75,48,120,168,20,31,22,26,59,131
2017,Lucas Nogueira\noguelu01,C,25,TOR,49,3,418,49,80,0.613,5,19,0.263,44,61,0.721,0.644,19,28,0.679,18,69,87,22,23,43,16,49,122
2017,Dirk Nowitzki\nowitdi01,C,39,DAL,77,77,1900,346,758,0.456,138,337,0.409,208,421,0.494,0.547,97,108,0.898,22,416,438,120,43,45,51,146,927
2017,Frank Ntilikina\ntilila01,PG,19,NYK,78,9,1706,182,500,0.364,50,157,0.318,132,343,0.385,0.414,49,68,0.721,37,140,177,250,65,18,131,181,463
2017,Jusuf Nurkić\nurkiju01,C,23,POR,79,79,2088,480,951,0.505,0,7,0,480,944,0.508,0.505,172,273,0.63,189,519,708,143,64,111,183,247,1132
2017,David Nwaba\nwabada01,SG,25,CHI,70,21,1646,202,423,0.478,18,52,0.346,184,371,0.496,0.499,133,203,0.655,89,237,326,104,59,29,77,158,555
2017,Johnny O'Bryant\obryajo01,PF,24,CHO,36,0,379,68,171,0.398,14,43,0.326,54,128,0.422,0.439,21,25,0.84,29,64,93,14,9,6,15,45,171
2017,Royce O'Neale\onealro01,SF,24,UTA,69,4,1150,120,284,0.423,42,118,0.356,78,166,0.47,0.496,61,76,0.803,25,211,236,95,36,16,55,105,343
2017,Kyle O'Quinn\oquinky01,C,27,NYK,77,10,1387,224,384,0.583,4,17,0.235,220,367,0.599,0.589,98,127,0.772,121,349,470,158,36,98,100,192,550
2017,Semi Ojeleye\ojelese01,PF,23,BOS,73,0,1150,65,188,0.346,40,125,0.32,25,63,0.397,0.452,25,41,0.61,37,124,161,20,21,4,25,91,195
2017,Emeka Okafor\okafoem01,C,35,NOP,26,19,353,48,95,0.505,0,0,,48,95,0.505,0.505,18,22,0.818,47,73,120,8,8,25,13,30,114
2017,Jahlil Okafor\okafoja01,C,22,TOT,28,0,353,77,138,0.558,1,4,0.25,76,134,0.567,0.562,21,29,0.724,21,64,85,12,3,18,21,51,176
2017,Jahlil Okafor\okafoja01,C,22,PHI,2,0,25,4,9,0.444,0,0,,4,9,0.444,0.444,2,4,0.5,4,5,9,1,0,2,3,7,10
2017,Jahlil Okafor\okafoja01,C,22,BRK,26,0,328,73,129,0.566,1,4,0.25,72,125,0.576,0.57,19,25,0.76,17,59,76,11,3,16,18,44,166
2017,Victor Oladipo\oladivi01,SG,25,IND,75,75,2552,640,1342,0.477,161,434,0.371,479,908,0.528,0.537,294,368,0.799,47,343,390,323,177,57,219,175,1735
2017,Kelly Olynyk\olynyke01,PF,26,MIA,76,22,1779,316,636,0.497,106,280,0.379,210,356,0.59,0.58,134,174,0.77,89,342,431,207,62,35,147,222,872
2017,Chinanu Onuaku\onuakch01,C,21,HOU,1,0,22,2,5,0.4,0,0,,2,5,0.4,0.4,0,0,,1,3,4,1,0,0,3,4,4
2017,Cedi Osman\osmande01,SF,22,CLE,61,12,672,90,186,0.484,32,87,0.368,58,99,0.586,0.57,26,46,0.565,19,101,120,41,22,3,32,78,238
2017,Kelly Oubre Jr.\oubreke01,SF,22,WAS,81,11,2231,318,790,0.403,126,369,0.341,192,421,0.456,0.482,191,233,0.82,59,304,363,98,80,35,90,234,953
2017,Zaza Pachulia\pachuza01,C,33,GSW,69,57,972,149,264,0.564,0,1,0,149,263,0.567,0.564,75,93,0.806,89,232,321,109,38,17,72,122,373
2017,Marcus Paige\paigema01,PG,24,CHO,5,0,28,4,14,0.286,2,8,0.25,2,6,0.333,0.357,2,2,1,0,4,4,3,0,0,0,0,12
2017,Georgios Papagiannis\papagge01,C,20,TOT,17,0,122,18,42,0.429,0,0,,18,42,0.429,0.429,0,0,,13,24,37,9,4,6,8,12,36
2017,Georgios Papagiannis\papagge01,C,20,SAC,16,0,118,17,41,0.415,0,0,,17,41,0.415,0.415,0,0,,12,24,36,9,2,6,8,12,34
2017,Georgios Papagiannis\papagge01,C,20,POR,1,0,4,1,1,1,0,0,,1,1,1,1,0,0,,1,0,1,0,2,0,0,0,2
2017,Jabari Parker\parkeja01,PF,22,MIL,31,3,743,160,332,0.482,31,81,0.383,129,251,0.514,0.529,40,54,0.741,42,109,151,59,25,10,45,50,391
2017,Tony Parker\parketo01,PG,35,SAS,55,21,1071,178,388,0.459,10,37,0.27,168,351,0.479,0.472,55,78,0.705,7,88,95,195,28,1,68,52,421
2017,Chandler Parsons\parsoch01,SF,29,MEM,36,8,691,108,234,0.462,51,121,0.421,57,113,0.504,0.571,17,27,0.63,14,76,90,69,18,11,35,53,284
2017,Patrick Patterson\pattepa01,PF,28,OKC,82,3,1270,106,266,0.398,66,171,0.386,40,95,0.421,0.523,40,46,0.87,32,161,193,57,48,23,33,87,318
2017,Justin Patton\pattoju01,C,20,MIN,1,0,4,1,2,0.5,0,0,,1,2,0.5,0.5,0,0,,0,0,0,0,1,0,0,1,2
2017,Brandon Paul\paulbr01,SG,26,SAS,64,2,576,55,127,0.433,15,54,0.278,40,73,0.548,0.492,22,43,0.512,6,62,68,37,25,7,29,58,147
2017,Chris Paul\paulch01,PG,32,HOU,58,58,1847,367,798,0.46,144,379,0.38,223,419,0.532,0.55,203,221,0.919,37,276,313,457,96,14,128,141,1081
2017,Adreian Payne\paynead01,PF,26,ORL,5,0,43,7,10,0.7,2,3,0.667,5,7,0.714,0.8,5,6,0.833,2,7,9,0,2,0,2,6,21
2017,Cameron Payne\payneca01,PG,23,CHI,25,14,582,87,215,0.405,35,91,0.385,52,124,0.419,0.486,12,16,0.75,18,51,69,113,26,9,36,44,221
2017,Elfrid Payton\paytoel01,PG,23,TOT,63,63,1808,329,667,0.493,30,92,0.326,299,575,0.52,0.516,109,168,0.649,64,210,274,393,83,22,168,147,797
2017,Elfrid Payton\paytoel01,PG,23,ORL,44,44,1257,238,458,0.52,25,67,0.373,213,391,0.545,0.547,72,114,0.632,47,127,174,275,64,16,114,97,573
2017,Elfrid Payton\paytoel01,PG,23,PHO,19,19,551,91,209,0.435,5,25,0.2,86,184,0.467,0.447,37,54,0.685,17,83,100,118,19,6,54,50,224
2017,Gary Payton II\paytoga02,PG,25,TOT,23,6,221,30,74,0.405,6,25,0.24,24,49,0.49,0.446,3,9,0.333,13,31,44,21,7,3,7,30,69
2017,Gary Payton II\paytoga02,PG,25,MIL,12,6,106,13,33,0.394,2,12,0.167,11,21,0.524,0.424,2,3,0.667,4,13,17,9,3,1,3,17,30
2017,Gary Payton II\paytoga02,PG,25,LAL,11,0,115,17,41,0.415,4,13,0.308,13,28,0.464,0.463,1,6,0.167,9,18,27,12,4,2,4,13,39
2017,Kendrick Perkins\perkike01,C,33,CLE,1,0,15,1,2,0.5,0,0,,1,2,0.5,0.5,1,2,0.5,0,1,1,2,1,0,1,1,3
2017,London Perrantes\perralo01,PG,23,CLE,14,0,66,2,13,0.154,0,3,0,2,10,0.2,0.154,3,5,0.6,1,3,4,5,2,1,1,6,7
2017,Alec Peters\peteral01,PF,22,PHO,20,0,225,28,74,0.378,18,58,0.31,10,16,0.625,0.5,8,10,0.8,8,29,37,12,2,2,4,13,82
2017,Marshall Plumlee\plumlma02,C,25,MIL,8,0,52,1,3,0.333,0,0,,1,3,0.333,0.333,12,16,0.75,4,13,17,2,0,1,3,10,14
2017,Mason Plumlee\plumlma01,C,27,DEN,74,26,1439,221,368,0.601,0,1,0,221,367,0.602,0.601,82,179,0.458,132,268,400,142,49,81,103,184,524
2017,Miles Plumlee\plumlmi01,C,29,ATL,55,35,918,105,180,0.583,0,0,,105,180,0.583,0.583,27,60,0.45,77,151,228,45,17,30,63,79,237
2017,Jakob Poeltl\poeltja01,C,22,TOR,82,0,1524,253,384,0.659,1,2,0.5,252,382,0.66,0.66,60,101,0.594,165,228,393,57,39,100,85,212,567
2017,Quincy Pondexter\pondequ01,SF,29,CHI,23,1,196,14,49,0.286,3,22,0.136,11,27,0.407,0.316,14,17,0.824,8,19,27,9,8,2,11,24,45
2017,Otto Porter\porteot01,SF,24,WAS,77,77,2432,445,885,0.503,138,313,0.441,307,572,0.537,0.581,106,128,0.828,103,389,492,157,116,41,75,151,1134
2017,Bobby Portis\portibo01,PF,22,CHI,73,4,1643,382,811,0.471,80,223,0.359,302,588,0.514,0.52,120,156,0.769,159,339,498,123,50,23,103,130,964
2017,Kristaps Porziņģis\porzikr01,PF,22,NYK,48,48,1553,390,889,0.439,90,228,0.395,300,661,0.454,0.489,218,275,0.793,62,254,316,57,36,115,93,141,1088
2017,Dwight Powell\poweldw01,C,26,DAL,79,25,1672,255,430,0.593,28,84,0.333,227,346,0.656,0.626,133,185,0.719,135,309,444,91,67,32,59,186,671
2017,Norman Powell\powelno01,SG,24,TOR,70,18,1062,150,374,0.401,53,186,0.285,97,188,0.516,0.472,32,39,0.821,14,105,119,89,37,16,66,111,385
2017,Alex Poythress\poythal01,PF,24,IND,25,0,104,11,26,0.423,4,11,0.364,7,15,0.467,0.5,0,0,,7,10,17,2,3,1,2,16,26
2017,Jacob Pullen\pulleja01,PG,28,PHI,3,0,6,1,2,0.5,0,1,0,1,1,1,0.5,0,0,,0,0,0,0,0,0,1,0,2
2017,Rodney Purvis\purviro01,SG,23,ORL,16,2,290,35,107,0.327,13,52,0.25,22,55,0.4,0.388,13,15,0.867,1,26,27,17,3,3,10,26,96
2017,Zhou Qi\qizh01,C,22,HOU,18,0,124,6,32,0.188,2,19,0.105,4,13,0.308,0.219,8,12,0.667,6,16,22,2,2,14,10,14,22
2017,Tim Quarterman\quartti01,SG,23,HOU,3,0,13,1,3,0.333,0,2,0,1,1,1,0.333,2,2,1,0,3,3,1,0,0,2,1,4
2017,Ivan Rabb\rabbiv01,PF,20,MEM,36,5,516,86,152,0.566,0,0,,86,152,0.566,0.566,29,36,0.806,53,105,158,32,12,13,35,55,201
2017,Julius Randle\randlju01,C,23,LAL,82,49,2190,504,904,0.558,10,45,0.222,494,859,0.575,0.563,305,425,0.718,181,473,654,210,43,45,213,274,1323
2017,Zach Randolph\randoza01,PF,36,SAC,59,57,1508,361,763,0.473,51,147,0.347,310,616,0.503,0.507,84,107,0.785,97,300,397,127,42,10,116,119,857
2017,Xavier Rathan-Mayes\rathaxa01,SG,23,MEM,5,0,118,12,42,0.286,1,14,0.071,11,28,0.393,0.298,4,9,0.444,0,5,5,18,6,3,11,18,29
2017,J.J. Redick\redicjj01,SG,33,PHI,70,70,2116,404,879,0.46,193,460,0.42,211,419,0.504,0.569,197,218,0.904,9,169,178,210,35,6,103,123,1198
2017,Davon Reed\reedda01,SG,22,PHO,21,1,242,22,76,0.289,11,38,0.289,11,38,0.289,0.362,8,12,0.667,2,37,39,13,10,2,10,17,63
2017,Willie Reed\reedwi02,C,27,TOT,42,5,428,81,121,0.669,1,2,0.5,80,119,0.672,0.674,32,55,0.582,35,86,121,10,9,22,19,56,195
2017,Willie Reed\reedwi02,C,27,LAC,39,5,419,80,120,0.667,1,2,0.5,79,118,0.669,0.671,32,55,0.582,35,85,120,9,9,22,19,53,193
2017,Willie Reed\reedwi02,C,27,DET,3,0,9,1,1,1,0,0,,1,1,1,1,0,0,,0,1,1,1,0,0,0,3,2
2017,Josh Richardson\richajo01,SF,24,MIA,81,81,2689,399,885,0.451,127,336,0.378,272,549,0.495,0.523,120,142,0.845,69,216,285,231,121,75,140,199,1045
2017,Malachi Richardson\richama01,SG,22,TOT,26,4,324,30,90,0.333,12,40,0.3,18,50,0.36,0.4,17,22,0.773,5,29,34,13,10,1,10,27,89
2017,Malachi Richardson\richama01,SG,22,SAC,25,4,319,29,88,0.33,12,39,0.308,17,49,0.347,0.398,17,22,0.773,5,28,33,13,10,1,10,27,87
2017,Malachi Richardson\richama01,SG,22,TOR,1,0,5,1,2,0.5,0,1,0,1,1,1,0.5,0,0,,0,1,1,0,0,0,0,0,2
2017,Austin Rivers\riverau01,SG,25,LAC,61,59,2057,341,805,0.424,136,360,0.378,205,445,0.461,0.508,102,159,0.642,27,118,145,242,74,16,109,152,920
2017,Andre Roberson\roberan03,SG,26,OKC,39,39,1037,87,162,0.537,8,36,0.222,79,126,0.627,0.562,12,38,0.316,75,110,185,46,45,35,30,89,194
2017,Devin Robinson\robinde01,SF,22,WAS,1,0,13,1,3,0.333,0,0,,1,3,0.333,0.333,0,0,,2,3,5,0,1,0,0,2,2
2017,Glenn Robinson III\robingl02,SF,24,IND,23,1,338,36,85,0.424,14,34,0.412,22,51,0.431,0.506,9,11,0.818,11,26,37,17,13,1,5,14,95
2017,Rajon Rondo\rondora01,PG,31,NOP,65,63,1705,231,494,0.468,50,150,0.333,181,344,0.526,0.518,25,46,0.543,31,232,263,533,70,10,151,119,537
2017,Derrick Rose\rosede01,PG,29,TOT,25,7,420,81,186,0.435,7,30,0.233,74,156,0.474,0.454,40,46,0.87,13,22,35,37,7,4,35,16,209
2017,Derrick Rose\rosede01,PG,29,CLE,16,7,308,58,132,0.439,6,24,0.25,52,108,0.481,0.462,35,41,0.854,10,19,29,26,3,4,28,14,157
2017,Derrick Rose\rosede01,PG,29,MIN,9,0,112,23,54,0.426,1,6,0.167,22,48,0.458,0.435,5,5,1,3,3,6,11,4,0,7,2,52
2017,Terrence Ross\rosste01,SG,26,ORL,24,20,600,76,191,0.398,30,93,0.323,46,98,0.469,0.476,27,36,0.75,10,63,73,38,27,11,29,45,209
2017,Terry Rozier\roziete01,PG,23,BOS,80,16,2068,316,800,0.395,153,402,0.381,163,398,0.41,0.491,115,149,0.772,63,313,376,232,80,19,80,123,900
2017,Ricky Rubio\rubiori01,PG,27,UTA,77,77,2254,346,827,0.418,96,273,0.352,250,554,0.451,0.476,220,254,0.866,44,307,351,410,121,11,207,206,1008
2017,D'Angelo Russell\russeda01,PG,21,BRK,48,35,1234,278,672,0.414,90,278,0.324,188,394,0.477,0.481,97,131,0.74,30,159,189,249,36,17,147,93,743
2017,Domantas Sabonis\sabondo01,C,21,IND,74,19,1810,340,661,0.514,13,37,0.351,327,624,0.524,0.524,168,224,0.75,165,407,572,151,40,32,137,220,861
2017,JaKarr Sampson\sampsja02,SF,24,SAC,22,6,344,44,81,0.543,5,10,0.5,39,71,0.549,0.574,10,16,0.625,21,57,78,9,8,22,8,48,103
2017,Dario Šarić\saricda01,PF,23,PHI,78,73,2310,403,890,0.453,157,399,0.393,246,491,0.501,0.541,178,207,0.86,154,366,520,202,51,20,148,160,1141
2017,Tomáš Satoranský\satorto01,SG,26,WAS,73,30,1643,201,384,0.523,47,101,0.465,154,283,0.544,0.585,75,96,0.781,72,161,233,286,52,15,83,131,524
2017,Dennis Schröder\schrode01,PG,24,ATL,67,67,2078,500,1146,0.436,76,262,0.29,424,884,0.48,0.469,225,265,0.849,44,164,208,417,72,6,183,147,1301
2017,Mike Scott\scottmi01,PF,29,WAS,76,1,1406,276,524,0.527,66,163,0.405,210,361,0.582,0.59,50,76,0.658,50,197,247,80,23,10,79,148,668
2017,Thabo Sefolosha\sefolth01,SF,33,UTA,38,6,806,118,240,0.492,32,84,0.381,86,156,0.551,0.558,44,54,0.815,29,132,161,33,52,12,30,59,312
2017,Wayne Selden\seldewa01,SG,23,MEM,35,9,692,116,269,0.431,49,122,0.402,67,147,0.456,0.522,44,59,0.746,16,40,56,66,18,5,54,59,325
2017,Ramon Sessions\sessira01,PG,31,TOT,28,3,392,42,117,0.359,8,26,0.308,34,91,0.374,0.393,44,57,0.772,6,32,38,77,14,2,30,29,136
2017,Ramon Sessions\sessira01,PG,31,NYK,13,3,167,17,53,0.321,2,11,0.182,15,42,0.357,0.34,12,15,0.8,1,17,18,27,7,1,15,14,48
2017,Ramon Sessions\sessira01,PG,31,WAS,15,0,225,25,64,0.391,6,15,0.4,19,49,0.388,0.438,32,42,0.762,5,15,20,50,7,1,15,15,88
2017,Iman Shumpert\shumpim01,SG,27,CLE,14,6,276,22,58,0.379,7,26,0.269,15,32,0.469,0.44,11,15,0.733,7,34,41,17,9,4,16,22,62
2017,Pascal Siakam\siakapa01,PF,23,TOR,81,5,1679,253,498,0.508,29,132,0.22,224,366,0.612,0.537,54,87,0.621,79,285,364,159,62,42,67,166,589
2017,Xavier Silas\silasxa01,SG,30,BOS,2,0,7,0,3,0,0,2,0,0,1,0,0,0,0,,1,1,2,0,1,0,0,1,0
2017,Ben Simmons\simmobe01,PG,21,PHI,81,81,2732,544,998,0.545,0,11,0,544,987,0.551,0.545,191,341,0.56,145,514,659,661,140,70,278,211,1279
2017,Jonathon Simmons\simmojo02,SG,28,ORL,69,50,2029,354,761,0.465,69,204,0.338,285,557,0.512,0.511,185,241,0.768,61,178,239,171,58,16,146,175,962
2017,Kobi Simmons\simmoko01,PG,20,MEM,32,12,643,80,189,0.423,11,39,0.282,69,150,0.46,0.452,25,25,1,14,36,50,68,18,5,44,61,196
2017,Kyle Singler\singlky01,SF,29,OKC,12,0,59,7,21,0.333,2,5,0.4,5,16,0.313,0.381,7,13,0.538,1,9,10,2,1,0,3,4,23
2017,Marcus Smart\smartma01,SG,23,BOS,54,11,1614,189,515,0.367,75,249,0.301,114,266,0.429,0.44,97,133,0.729,43,146,189,259,71,23,129,133,550
2017,Dennis Smith Jr.\smithde03,PG,20,DAL,69,69,2049,404,1024,0.395,106,339,0.313,298,685,0.435,0.446,134,193,0.694,50,210,260,358,71,18,194,152,1048
2017,Ish Smith\smithis01,PG,29,DET,82,35,2043,389,801,0.486,35,101,0.347,354,700,0.506,0.507,81,116,0.698,27,197,224,360,64,20,108,140,894
2017,J.R. Smith\smithjr01,SG,32,CLE,80,61,2244,240,595,0.403,143,381,0.375,97,214,0.453,0.524,39,56,0.696,29,206,235,141,68,11,81,161,662
2017,Jason Smith\smithja02,C,31,WAS,33,2,285,45,115,0.391,4,32,0.125,41,83,0.494,0.409,19,21,0.905,18,35,53,14,3,13,16,44,113
2017,Josh Smith\smithjo03,PF,32,NOP,3,0,12,1,4,0.25,0,0,,1,4,0.25,0.25,0,0,,3,1,4,0,0,0,0,3,2
2017,Tony Snell\snellto01,SG,26,MIL,75,59,2053,185,425,0.435,108,268,0.403,77,157,0.49,0.562,38,48,0.792,9,132,141,98,47,28,36,115,516
2017,Marreese Speights\speigma01,C,30,ORL,52,3,675,138,349,0.395,86,233,0.369,52,116,0.448,0.519,40,55,0.727,21,112,133,40,8,22,40,106,402
2017,Nik Stauskas\stausni01,SG,24,TOT,41,0,523,60,154,0.39,40,100,0.4,20,54,0.37,0.519,21,29,0.724,4,60,64,39,9,4,26,24,181
2017,Nik Stauskas\stausni01,SG,24,PHI,6,0,45,1,4,0.25,0,1,0,1,3,0.333,0.25,2,2,1,0,1,1,1,4,0,4,3,4
2017,Nik Stauskas\stausni01,SG,24,BRK,35,0,478,59,150,0.393,40,99,0.404,19,51,0.373,0.527,19,27,0.704,4,59,63,38,5,4,22,21,177
2017,Lance Stephenson\stephla01,SG,27,IND,82,7,1850,303,709,0.427,67,232,0.289,236,477,0.495,0.475,84,127,0.661,62,362,424,235,46,17,131,177,757
2017,David Stockton\stockda01,PG,26,UTA,3,0,9,2,3,0.667,2,3,0.667,0,0,,1,4,4,1,0,0,0,0,0,0,1,3,10
2017,Julyan Stone\stoneju01,SG,29,CHO,23,0,175,6,13,0.462,6,13,0.462,0,0,,0.692,1,2,0.5,1,28,29,26,4,2,7,21,19
2017,Edmond Sumner\sumneed01,PG,22,IND,1,0,2,1,1,1,0,0,,1,1,1,1,0,0,,0,1,1,0,0,0,0,1,2
2017,Caleb Swanigan\swanica01,PF,20,POR,27,3,189,24,60,0.4,1,8,0.125,23,52,0.442,0.408,12,18,0.667,15,39,54,14,5,3,18,37,61
2017,Jayson Tatum\tatumja01,SF,19,BOS,80,80,2438,397,835,0.475,105,242,0.434,292,593,0.492,0.538,213,258,0.826,50,352,402,128,83,58,114,170,1112
2017,Isaiah Taylor\taylois01,PG,23,ATL,67,9,1167,163,390,0.418,20,80,0.25,143,310,0.461,0.444,99,141,0.702,22,72,94,206,34,10,84,116,445
2017,Jeff Teague\teaguje01,PG,29,MIN,70,70,2311,354,794,0.446,84,228,0.368,270,566,0.477,0.499,202,239,0.845,24,185,209,492,102,23,177,171,994
2017,Marquis Teague\teaguma01,PG,24,MEM,3,0,74,4,16,0.25,1,4,0.25,3,12,0.25,0.281,2,5,0.4,1,5,6,13,4,0,3,5,11
2017,Mirza Teletović\teletmi01,PF,32,MIL,10,0,159,25,57,0.439,21,45,0.467,4,12,0.333,0.623,0,0,,3,20,23,10,4,1,7,14,71
2017,Garrett Temple\templga01,SG,31,SAC,65,35,1615,199,476,0.418,89,227,0.392,110,249,0.442,0.512,60,78,0.769,22,130,152,124,57,27,79,135,547
2017,Miloš Teodosić\teodomi01,PG,30,LAC,45,36,1134,151,360,0.419,88,232,0.379,63,128,0.492,0.542,39,46,0.848,16,110,126,209,23,5,97,103,429
2017,Jason Terry\terryja01,SG,40,MIL,51,4,814,59,154,0.383,40,115,0.348,19,39,0.487,0.513,8,9,0.889,5,43,48,59,42,13,25,52,166
2017,Daniel Theis\theisda01,C,25,BOS,63,3,936,126,233,0.541,18,58,0.31,108,175,0.617,0.579,61,81,0.753,90,184,274,56,30,48,56,157,331
2017,Isaiah Thomas\thomais02,PG,28,TOT,32,15,862,157,421,0.373,55,188,0.293,102,233,0.438,0.438,117,131,0.893,17,50,67,153,15,3,95,58,486
2017,Isaiah Thomas\thomais02,PG,28,CLE,15,14,406,70,194,0.361,22,87,0.253,48,107,0.449,0.418,59,68,0.868,7,24,31,68,9,2,41,25,221
2017,Isaiah Thomas\thomais02,PG,28,LAL,17,1,456,87,227,0.383,33,101,0.327,54,126,0.429,0.456,58,63,0.921,10,26,36,85,6,1,54,33,265
2017,Lance Thomas\thomala01,PF,29,NYK,73,31,1353,102,267,0.382,50,124,0.403,52,143,0.364,0.476,44,53,0.83,44,131,175,44,30,14,40,134,298
2017,Klay Thompson\thompkl01,SG,27,GSW,73,73,2506,575,1179,0.488,229,521,0.44,346,658,0.526,0.585,82,98,0.837,31,246,277,185,55,34,128,117,1461
2017,Tristan Thompson\thomptr01,C,26,CLE,53,22,1072,132,235,0.562,0,0,,132,235,0.562,0.562,43,79,0.544,126,226,352,33,16,17,36,102,307
2017,Sindarius Thornwell\thornsi01,SG,23,LAC,73,17,1156,100,233,0.429,23,61,0.377,77,172,0.448,0.479,59,88,0.67,33,107,140,68,48,25,53,125,282
2017,Anthony Tolliver\tollian01,PF,32,DET,79,14,1757,219,472,0.464,159,365,0.436,60,107,0.561,0.632,106,133,0.797,50,191,241,90,32,21,58,144,703
2017,Karl-Anthony Towns\townska01,C,22,MIN,82,82,2918,639,1172,0.545,120,285,0.421,519,887,0.585,0.596,345,402,0.858,238,774,1012,199,64,115,159,285,1743
2017,P.J. Tucker\tuckepj01,PF,32,HOU,82,34,2281,172,441,0.39,115,310,0.371,57,131,0.435,0.52,43,60,0.717,93,364,457,77,78,26,74,205,502
2017,Evan Turner\turneev01,SF,29,POR,79,40,2034,258,577,0.447,42,132,0.318,216,445,0.485,0.484,91,107,0.85,30,214,244,173,47,29,99,163,649
2017,Myles Turner\turnemy01,C,21,IND,65,62,1836,306,639,0.479,56,157,0.357,250,482,0.519,0.523,160,206,0.777,93,324,417,87,38,118,96,186,828
2017,Ekpe Udoh\udohek01,C,30,UTA,63,3,810,60,120,0.5,0,1,0,60,119,0.504,0.5,42,56,0.75,68,82,150,53,43,74,20,105,162
2017,Tyler Ulis\ulisty01,PG,22,PHO,71,43,1658,214,551,0.388,42,146,0.288,172,405,0.425,0.426,84,101,0.832,24,104,128,311,70,7,127,120,554
2017,Jonas Valančiūnas\valanjo01,C,25,TOR,77,77,1727,390,687,0.568,30,74,0.405,360,613,0.587,0.59,170,211,0.806,183,477,660,81,29,69,115,192,980
2017,Denzel Valentine\valende01,SG,24,CHI,77,37,2095,301,721,0.417,143,370,0.386,158,351,0.45,0.517,38,51,0.745,48,345,393,244,65,11,99,185,783
2017,Fred VanVleet\vanvlfr01,PG,23,TOR,76,0,1520,232,545,0.426,108,261,0.414,124,284,0.437,0.525,84,101,0.832,25,159,184,243,68,19,74,130,656
2017,Rashad Vaughn\vaughra01,SG,21,TOT,28,0,212,23,56,0.411,14,37,0.378,9,19,0.474,0.536,4,6,0.667,3,18,21,13,5,3,6,15,64
2017,Rashad Vaughn\vaughra01,SG,21,MIL,22,0,173,21,50,0.42,13,35,0.371,8,15,0.533,0.55,4,6,0.667,2,15,17,12,4,3,4,12,59
2017,Rashad Vaughn\vaughra01,SG,21,BRK,1,0,4,0,0,,0,0,,0,0,,,0,0,,0,0,0,1,0,0,0,1,0
2017,Rashad Vaughn\vaughra01,SG,21,ORL,5,0,35,2,6,0.333,1,2,0.5,1,4,0.25,0.417,0,0,,1,3,4,0,1,0,2,2,5
2017,Noah Vonleh\vonleno01,PF,22,TOT,54,16,875,104,234,0.444,20,66,0.303,84,168,0.5,0.487,36,58,0.621,70,241,311,34,19,17,31,68,264
2017,Noah Vonleh\vonleno01,PF,22,POR,33,12,476,47,96,0.49,2,6,0.333,45,90,0.5,0.5,23,31,0.742,35,132,167,13,6,11,15,42,119
2017,Noah Vonleh\vonleno01,PF,22,CHI,21,4,399,57,138,0.413,18,60,0.3,39,78,0.5,0.478,13,27,0.481,35,109,144,21,13,6,16,26,145
2017,Nikola Vučević\vucevni01,C,27,ORL,57,57,1683,399,840,0.475,64,204,0.314,335,636,0.527,0.513,77,94,0.819,101,422,523,191,56,62,109,144,939
2017,Dwyane Wade\wadedw01,SG,36,TOT,67,3,1536,299,682,0.438,32,111,0.288,267,571,0.468,0.462,135,189,0.714,50,202,252,228,61,47,140,124,765
2017,Dwyane Wade\wadedw01,SG,36,CLE,46,3,1069,198,435,0.455,23,70,0.329,175,365,0.479,0.482,94,134,0.701,39,142,181,163,42,32,92,84,513
2017,Dwyane Wade\wadedw01,SG,36,MIA,21,0,467,101,247,0.409,9,41,0.22,92,206,0.447,0.427,41,55,0.745,11,60,71,65,19,15,48,40,252
2017,Dion Waiters\waitedi01,SG,26,MIA,30,30,918,163,410,0.398,52,170,0.306,111,240,0.463,0.461,51,69,0.739,8,69,77,113,23,9,70,61,429
2017,Kemba Walker\walkeke02,PG,27,CHO,80,80,2736,588,1363,0.431,231,601,0.384,357,762,0.469,0.516,363,420,0.864,32,216,248,444,91,24,179,98,1770
2017,John Wall\walljo01,PG,27,WAS,41,41,1410,280,667,0.42,62,167,0.371,218,500,0.436,0.466,175,241,0.726,22,128,150,393,57,45,158,80,797
2017,Tyrone Wallace\wallaty01,PG,23,LAC,30,19,851,110,247,0.445,10,40,0.25,100,207,0.483,0.466,61,78,0.782,21,84,105,71,27,13,46,83,291
2017,Taurean Prince\princta02,SF,23,ATL,82,82,2464,415,975,0.426,176,457,0.385,239,518,0.461,0.516,152,180,0.844,50,339,389,214,85,42,191,168,1158
2017,Derrick Walton\waltode01,PG,22,MIA,16,0,147,8,25,0.32,7,17,0.412,1,8,0.125,0.46,6,6,1,2,14,16,16,7,3,2,7,29
2017,Jameel Warney\warneja01,PF,24,DAL,3,0,27,7,12,0.583,0,0,,7,12,0.583,0.583,3,5,0.6,4,5,9,0,0,0,1,2,17
2017,T.J. Warren\warretj01,SF,24,PHO,65,65,2142,529,1063,0.498,20,90,0.222,509,973,0.523,0.507,193,255,0.757,125,208,333,85,65,41,85,149,1271
2017,Travis Wear\weartr01,SF,27,LAL,17,0,228,25,72,0.347,17,47,0.362,8,25,0.32,0.465,8,8,1,0,38,38,7,4,5,6,30,75
2017,James Webb III\webbja01,SF,24,BRK,10,0,120,6,24,0.25,4,19,0.211,2,5,0.4,0.333,0,0,,8,16,24,4,1,0,4,10,16
2017,Briante Weber\weberbr01,PG,25,TOT,18,0,237,19,43,0.442,4,11,0.364,15,32,0.469,0.488,8,10,0.8,8,27,35,22,18,5,15,28,50
2017,Briante Weber\weberbr01,PG,25,HOU,13,0,118,9,22,0.409,4,9,0.444,5,13,0.385,0.5,4,4,1,3,15,18,13,10,3,7,18,26
2017,Briante Weber\weberbr01,PG,25,MEM,5,0,119,10,21,0.476,0,2,0,10,19,0.526,0.476,4,6,0.667,5,12,17,9,8,2,8,10,24
2017,David West\westda01,C,37,GSW,73,0,999,216,378,0.571,3,8,0.375,213,370,0.576,0.575,60,79,0.759,64,174,238,138,47,75,80,120,495
2017,Russell Westbrook\westbru01,PG,29,OKC,80,80,2914,757,1687,0.449,97,326,0.298,660,1361,0.485,0.477,417,566,0.737,152,652,804,820,147,20,381,200,2028
2017,Andrew White\whitean01,SF,24,ATL,15,0,209,25,73,0.342,18,49,0.367,7,24,0.292,0.466,1,4,0.25,4,30,34,6,3,1,8,12,69
2017,Derrick White\whitede01,PG,23,SAS,17,0,139,16,33,0.485,8,13,0.615,8,20,0.4,0.606,14,20,0.7,5,21,26,9,4,3,6,8,54
2017,Okaro White\whiteok01,PF,25,MIA,6,4,80,7,16,0.438,4,11,0.364,3,5,0.6,0.563,2,3,0.667,3,8,11,2,1,1,1,6,20
2017,Isaiah Whitehead\whiteis01,PG,22,BRK,16,0,180,40,86,0.465,7,18,0.389,33,68,0.485,0.506,13,19,0.684,4,22,26,20,8,2,24,23,100
2017,Hassan Whiteside\whiteha01,C,28,MIA,54,54,1364,312,578,0.54,2,2,1,310,576,0.538,0.542,128,182,0.703,174,444,618,54,37,94,92,131,754
2017,Andrew Wiggins\wiggian01,SF,22,MIN,82,82,2979,569,1300,0.438,112,338,0.331,457,962,0.475,0.481,202,314,0.643,82,276,358,160,91,51,138,163,1452
2017,Jacob Wiley\wileyja01,PF,23,BRK,5,0,33,1,4,0.25,1,2,0.5,0,2,0,0.375,1,2,0.5,2,9,11,2,1,0,0,4,4
2017,Damien Wilkins\wilkida02,SF,38,IND,19,1,152,13,39,0.333,4,18,0.222,9,21,0.429,0.385,3,4,0.75,5,11,16,9,2,1,5,7,33
2017,Alan Williams\willial03,PF,25,PHO,5,0,70,7,18,0.389,0,0,,7,18,0.389,0.389,6,9,0.667,3,19,22,8,5,1,7,13,20
2017,C.J. Williams\willicj01,SG,27,LAC,38,17,707,87,197,0.442,22,78,0.282,65,119,0.546,0.497,13,16,0.813,12,44,56,43,31,13,20,63,209
2017,Derrick Williams\willide02,PF,26,LAL,2,0,9,1,4,0.25,0,2,0,1,2,0.5,0.25,0,0,,0,1,1,0,0,0,0,0,2
2017,Lou Williams\willilo02,SG,31,LAC,79,19,2589,582,1337,0.435,186,518,0.359,396,819,0.484,0.505,432,491,0.88,40,158,198,417,85,19,234,106,1782
2017,Marvin Williams\willima02,PF,31,CHO,78,78,2006,258,563,0.458,126,305,0.413,132,258,0.512,0.57,102,123,0.829,74,296,370,96,56,38,66,116,744
2017,Matt Williams\willima05,SG,24,MIA,3,0,11,2,6,0.333,1,5,0.2,1,1,1,0.417,0,0,,0,1,1,0,0,0,1,1,5
2017,Troy Williams\willitr02,SF,23,TOT,21,1,307,51,109,0.468,11,38,0.289,40,71,0.563,0.518,20,30,0.667,22,41,63,16,20,4,19,34,133
2017,Troy Williams\willitr02,SF,23,HOU,4,0,17,2,9,0.222,0,5,0,2,4,0.5,0.222,1,3,0.333,1,3,4,1,1,0,1,2,5
2017,Troy Williams\willitr02,SF,23,NYK,17,1,290,49,100,0.49,11,33,0.333,38,67,0.567,0.545,19,27,0.704,21,38,59,15,19,4,18,32,128
2017,D.J. Wilson\wilsodj01,PF,21,MIL,22,0,71,9,16,0.563,2,5,0.4,7,11,0.636,0.625,1,2,0.5,2,8,10,3,3,1,4,7,21
2017,Jamil Wilson\wilsoja02,SF,27,LAC,15,10,274,38,81,0.469,27,63,0.429,11,18,0.611,0.636,2,4,0.5,3,29,32,10,5,8,8,34,105
2017,Justise Winslow\winslju01,PF,21,MIA,68,25,1680,207,488,0.424,49,129,0.38,158,359,0.44,0.474,66,104,0.635,64,306,370,148,54,33,77,140,529
2017,Jeff Withey\witheje01,C,27,DAL,9,0,39,6,16,0.375,2,10,0.2,4,6,0.667,0.438,1,2,0.5,1,9,10,0,0,3,2,3,15
2017,Nate Wolters\woltena01,PG,26,UTA,5,0,19,1,6,0.167,0,0,,1,6,0.167,0.167,0,0,,1,1,2,1,0,0,0,1,2
2017,Brandan Wright\wrighbr03,PF,30,TOT,28,1,381,59,102,0.578,0,0,,59,102,0.578,0.578,21,33,0.636,33,62,95,13,13,26,8,32,139
2017,Brandan Wright\wrighbr03,PF,30,MEM,27,1,366,57,99,0.576,0,0,,57,99,0.576,0.576,21,33,0.636,32,61,93,13,13,25,8,29,135
2017,Brandan Wright\wrighbr03,PF,30,HOU,1,0,15,2,3,0.667,0,0,,2,3,0.667,0.667,0,0,,1,1,2,0,0,1,0,3,4
2017,Delon Wright\wrighde01,PG,25,TOR,69,4,1433,201,432,0.465,56,153,0.366,145,279,0.52,0.53,97,117,0.829,45,153,198,200,72,33,78,81,555
2017,Guerschon Yabusele\yabusgu01,PF,22,BOS,33,4,235,26,61,0.426,12,37,0.324,14,24,0.583,0.525,15,22,0.682,17,35,52,16,4,5,12,23,79
2017,James Young\youngja01,SG,22,PHI,6,0,61,5,14,0.357,3,10,0.3,2,4,0.5,0.464,4,6,0.667,0,2,2,2,0,0,1,4,17
2017,Joe Young\youngjo01,PG,25,IND,53,1,558,80,186,0.43,25,66,0.379,55,120,0.458,0.497,22,29,0.759,12,51,63,39,14,1,26,39,207
2017,Nick Young\youngni01,SG,32,GSW,80,8,1393,201,488,0.412,123,326,0.377,78,162,0.481,0.538,56,65,0.862,20,105,125,36,38,7,39,100,581
2017,Thaddeus Young\youngth01,PF,29,IND,81,81,2607,421,864,0.487,58,181,0.32,363,683,0.531,0.521,55,92,0.598,184,328,512,152,135,36,105,175,955
2017,Cody Zeller\zelleco01,C,25,CHO,33,0,627,85,156,0.545,2,3,0.667,83,153,0.542,0.551,61,85,0.718,67,110,177,31,14,21,33,81,233
2017,Tyler Zeller\zellety01,C,28,TOT,66,34,1109,187,334,0.56,10,28,0.357,177,306,0.578,0.575,57,79,0.722,110,195,305,47,15,35,47,126,441
2017,Tyler Zeller\zellety01,C,28,BRK,42,33,703,125,229,0.546,10,26,0.385,115,203,0.567,0.568,40,60,0.667,63,131,194,28,8,21,35,78,300
2017,Tyler Zeller\zellety01,C,28,MIL,24,1,406,62,105,0.59,0,2,0,62,103,0.602,0.59,17,19,0.895,47,64,111,19,7,14,12,48,141
2017,Paul Zipser\zipsepa01,SF,23,CHI,54,12,824,81,234,0.346,37,110,0.336,44,124,0.355,0.425,19,25,0.76,13,118,131,46,20,15,43,86,218
2017,Ante Žižić\zizican01,C,21,CLE,32,2,214,49,67,0.731,0,0,,49,67,0.731,0.731,21,29,0.724,24,36,60,5,2,13,11,30,119
2017,Ivica Zubac\zubaciv01,C,20,LAL,43,0,410,61,122,0.5,0,1,0,61,121,0.504,0.5,39,51,0.765,45,78,123,25,8,15,26,47,161
2016,Álex Abrines\abrinal01,SG,23,OKC,68,6,1055,134,341,0.393,94,247,0.381,40,94,0.426,0.531,44,49,0.898,18,68,86,40,37,8,33,114,406
2016,Quincy Acy\acyqu01,PF,26,TOT,38,1,558,70,170,0.412,37,90,0.411,33,80,0.413,0.521,45,60,0.75,20,95,115,18,14,15,21,67,222
2016,Quincy Acy\acyqu01,PF,26,DAL,6,0,48,5,17,0.294,1,7,0.143,4,10,0.4,0.324,2,3,0.667,2,6,8,0,0,0,2,9,13
2016,Quincy Acy\acyqu01,PF,26,BRK,32,1,510,65,153,0.425,36,83,0.434,29,70,0.414,0.542,43,57,0.754,18,89,107,18,14,15,19,58,209
2016,Steven Adams\adamsst01,C,23,OKC,80,80,2389,374,655,0.571,0,1,0,374,654,0.572,0.571,157,257,0.611,281,332,613,86,89,78,146,195,905
2016,Arron Afflalo\afflaar01,SG,31,SAC,61,45,1580,185,420,0.44,62,151,0.411,123,269,0.457,0.514,83,93,0.892,9,116,125,78,21,6,42,104,515
2016,Alexis Ajinça\ajincal01,C,28,NOP,39,15,584,89,178,0.5,0,4,0,89,174,0.511,0.5,29,40,0.725,46,131,177,12,20,22,31,77,207
2016,Cole Aldrich\aldrico01,C,28,MIN,62,0,531,45,86,0.523,0,0,,45,86,0.523,0.523,15,22,0.682,51,107,158,25,25,23,17,85,105
2016,LaMarcus Aldridge\aldrila01,PF,31,SAS,72,72,2335,500,1049,0.477,23,56,0.411,477,993,0.48,0.488,220,271,0.812,172,351,523,139,46,88,98,158,1243
2016,Lavoy Allen\allenla01,PF,27,IND,61,5,871,77,168,0.458,0,1,0,77,167,0.461,0.458,23,33,0.697,105,114,219,57,18,24,29,78,177
2016,Tony Allen\allento01,SG,35,MEM,71,66,1914,274,595,0.461,15,54,0.278,259,541,0.479,0.473,80,130,0.615,166,225,391,98,115,29,100,178,643
2016,Al-Farouq Aminu\aminual01,PF,26,POR,61,25,1773,183,466,0.393,70,212,0.33,113,254,0.445,0.468,96,136,0.706,77,374,451,99,60,44,94,102,532
2016,Chris Andersen\anderch01,C,38,CLE,12,0,114,9,22,0.409,0,3,0,9,19,0.474,0.409,10,14,0.714,9,22,31,5,5,7,5,20,28
2016,Alan Anderson\anderal01,SF,34,LAC,30,0,308,30,80,0.375,14,44,0.318,16,36,0.444,0.463,12,16,0.75,3,21,24,11,3,0,7,35,86
2016,Justin Anderson\anderju01,SF,23,TOT,75,10,1228,186,439,0.424,58,194,0.299,128,245,0.522,0.49,102,129,0.791,69,176,245,66,41,23,66,109,532
2016,Justin Anderson\anderju01,SF,23,DAL,51,2,710,111,277,0.401,37,122,0.303,74,155,0.477,0.468,70,88,0.795,39,110,149,32,28,16,40,64,329
2016,Justin Anderson\anderju01,SF,23,PHI,24,8,518,75,162,0.463,21,72,0.292,54,90,0.6,0.528,32,41,0.78,30,66,96,34,13,7,26,45,203
2016,Kyle Anderson\anderky01,SF,23,SAS,72,14,1020,93,209,0.445,15,40,0.375,78,169,0.462,0.481,45,57,0.789,33,175,208,91,51,26,39,63,246
2016,Ryan Anderson\anderry01,PF,28,HOU,72,72,2116,323,773,0.418,204,506,0.403,119,267,0.446,0.55,129,150,0.86,112,218,330,68,31,14,55,142,979
2016,Giannis Antetokounmpo\antetgi01,SF,22,MIL,80,80,2845,656,1259,0.521,49,180,0.272,607,1079,0.563,0.541,471,612,0.77,142,558,700,434,131,151,234,246,1832
2016,Carmelo Anthony\anthoca01,SF,32,NYK,74,74,2538,602,1389,0.433,151,421,0.359,451,968,0.466,0.488,304,365,0.833,62,376,438,213,60,34,153,198,1659
2016,Joel Anthony\anthojo01,C,34,SAS,19,0,122,10,16,0.625,0,0,,10,16,0.625,0.625,5,8,0.625,8,23,31,3,2,6,4,11,25
2016,Trevor Ariza\arizatr01,SF,31,HOU,80,80,2773,326,798,0.409,191,555,0.344,135,243,0.556,0.528,93,126,0.738,54,404,458,175,147,20,73,133,936
2016,Darrell Arthur\arthuda01,PF,28,DEN,41,7,639,95,215,0.442,53,117,0.453,42,98,0.429,0.565,19,22,0.864,25,87,112,42,19,21,36,76,262
2016,Ömer Aşık\asikom01,C,30,NOP,31,19,482,31,65,0.477,0,0,,31,65,0.477,0.477,23,39,0.59,48,115,163,15,5,10,14,51,85
2016,D.J. Augustin\augusdj01,PG,29,ORL,78,20,1538,195,517,0.377,95,274,0.347,100,243,0.412,0.469,131,161,0.814,15,102,117,209,31,1,90,101,616
2016,Luke Babbitt\babbilu01,SF,27,MIA,68,55,1065,113,281,0.402,87,210,0.414,26,71,0.366,0.557,11,15,0.733,12,129,141,36,20,11,25,118,324
2016,Ron Baker\bakerro01,SG,23,NYK,52,13,857,82,217,0.378,23,86,0.267,59,131,0.45,0.431,28,43,0.651,12,86,98,107,34,8,56,74,215
2016,Wade Baldwin\baldwwa01,PG,20,MEM,33,1,405,36,115,0.313,3,22,0.136,33,93,0.355,0.326,31,37,0.838,11,35,46,61,18,7,39,40,106
2016,Leandro Barbosa\barbole01,SG,34,PHO,67,0,963,172,392,0.439,35,98,0.357,137,294,0.466,0.483,40,45,0.889,15,89,104,81,31,8,48,82,419
2016,J.J. Barea\bareajo01,PG,32,DAL,35,6,771,142,343,0.414,53,148,0.358,89,195,0.456,0.491,44,51,0.863,9,75,84,193,14,1,63,30,381
2016,Harrison Barnes\barneha02,PF,24,DAL,79,79,2803,599,1280,0.468,78,222,0.351,521,1058,0.492,0.498,242,281,0.861,93,301,394,116,65,15,102,128,1518
2016,Matt Barnes\barnema02,SF,36,TOT,74,18,1777,185,473,0.391,87,263,0.331,98,210,0.467,0.483,70,89,0.787,70,314,384,195,48,26,107,185,527
2016,Matt Barnes\barnema02,SF,36,SAC,54,13,1367,147,383,0.384,69,211,0.327,78,172,0.453,0.474,50,66,0.758,55,238,293,150,36,17,83,138,413
2016,Matt Barnes\barnema02,SF,36,GSW,20,5,410,38,90,0.422,18,52,0.346,20,38,0.526,0.522,20,23,0.87,15,76,91,45,12,9,24,47,114
2016,Will Barton\bartowi01,SG,26,DEN,60,19,1705,295,666,0.443,87,235,0.37,208,431,0.483,0.508,143,190,0.753,58,201,259,206,48,28,97,110,820
2016,Brandon Bass\bassbr01,PF,31,LAC,52,0,577,107,186,0.575,1,3,0.333,106,183,0.579,0.578,77,88,0.875,43,86,129,21,14,11,29,45,292
2016,Nicolas Batum\batumni01,SG,28,CHO,77,77,2617,393,975,0.403,135,405,0.333,258,570,0.453,0.472,243,284,0.856,46,435,481,456,86,29,194,109,1164
2016,Jerryd Bayless\bayleje01,PG,28,PHI,3,1,71,11,32,0.344,2,5,0.4,9,27,0.333,0.375,9,10,0.9,3,9,12,13,0,0,9,4,33
2016,Aron Baynes\baynear01,C,30,DET,75,2,1163,143,279,0.513,0,0,,143,279,0.513,0.513,79,94,0.84,111,222,333,32,17,39,50,166,365
2016,Kent Bazemore\bazemke01,SF,27,ATL,73,64,1963,295,721,0.409,92,266,0.346,203,455,0.446,0.473,119,168,0.708,45,186,231,177,91,52,125,165,801
2016,Bradley Beal\bealbr01,SG,23,WAS,77,77,2684,637,1322,0.482,223,552,0.404,414,770,0.538,0.566,282,342,0.825,53,187,240,267,83,21,156,169,1779
2016,Malik Beasley\beaslma01,SG,20,DEN,22,1,165,33,73,0.452,9,28,0.321,24,45,0.533,0.514,8,10,0.8,5,12,17,11,7,0,8,10,83
2016,Michael Beasley\beaslmi01,PF,28,MIL,56,6,935,216,406,0.532,18,43,0.419,198,363,0.545,0.554,78,105,0.743,40,153,193,53,27,27,66,92,528
2016,Marco Belinelli\belinma01,SG,30,CHO,74,0,1778,264,615,0.429,102,283,0.36,162,332,0.488,0.512,150,168,0.893,14,164,178,147,44,9,70,90,780
2016,DeAndre' Bembry\bembrde01,SF,22,ATL,38,1,371,47,98,0.48,1,18,0.056,46,80,0.575,0.485,6,16,0.375,14,45,59,28,8,5,16,21,101
2016,Dragan Bender\bendedr01,PF,19,PHO,43,0,574,57,161,0.354,28,101,0.277,29,60,0.483,0.441,4,11,0.364,23,80,103,23,10,22,32,74,146
2016,Anthony Bennett\bennean01,PF,23,BRK,23,1,264,38,92,0.413,13,48,0.271,25,44,0.568,0.484,26,36,0.722,25,53,78,12,5,3,12,18,115
2016,Ben Bentil\bentibe01,PF,21,DAL,3,0,10,0,3,0,0,1,0,0,2,0,0,0,0,,0,2,2,0,0,0,1,1,0
2016,Dāvis Bertāns\bertada01,PF,24,SAS,67,6,808,103,234,0.44,69,173,0.399,34,61,0.557,0.588,28,34,0.824,22,76,98,46,20,28,32,75,303
2016,Patrick Beverley\beverpa01,SG,28,HOU,67,67,2058,228,543,0.42,110,288,0.382,118,255,0.463,0.521,73,95,0.768,95,298,393,281,99,25,100,222,639
2016,Bismack Biyombo\biyombi01,C,24,ORL,81,27,1793,179,339,0.528,0,0,,179,339,0.528,0.528,125,234,0.534,157,410,567,74,25,91,95,202,483
2016,Nemanja Bjelica\bjeline01,PF,28,MIN,65,1,1190,151,356,0.424,56,177,0.316,95,179,0.531,0.503,45,61,0.738,57,187,244,79,40,20,59,154,403
2016,Tarik Black\blackta01,C,25,LAL,67,16,1091,150,294,0.51,1,2,0.5,149,292,0.51,0.512,82,109,0.752,144,199,343,39,29,44,58,173,383
2016,Eric Bledsoe\bledser01,PG,27,PHO,66,66,2176,449,1034,0.434,104,310,0.335,345,724,0.477,0.485,388,458,0.847,52,268,320,418,91,31,224,164,1390
2016,Bojan Bogdanović\bogdabo02,SF,27,TOT,81,54,2083,376,845,0.445,144,392,0.367,232,453,0.512,0.53,217,243,0.893,37,240,277,111,34,7,131,146,1113
2016,Bojan Bogdanović\bogdabo02,SF,27,BRK,55,54,1482,269,611,0.44,99,277,0.357,170,334,0.509,0.521,146,167,0.874,23,174,197,90,24,3,93,99,783
2016,Bojan Bogdanović\bogdabo02,SF,27,WAS,26,0,601,107,234,0.457,45,115,0.391,62,119,0.521,0.553,71,76,0.934,14,66,80,21,10,4,38,47,330
2016,Andrew Bogut\bogutan01,C,32,TOT,27,21,583,38,81,0.469,0,1,0,38,80,0.475,0.469,3,11,0.273,56,162,218,49,13,25,43,86,79
2016,Andrew Bogut\bogutan01,C,32,DAL,26,21,582,38,81,0.469,0,1,0,38,80,0.475,0.469,3,11,0.273,56,162,218,49,13,25,43,84,79
2016,Andrew Bogut\bogutan01,C,32,CLE,1,0,1,0,0,,0,0,,0,0,,,0,0,,0,0,0,0,0,0,0,2,0
2016,Joel Bolomboy\bolomjo01,PF,23,UTA,12,0,53,9,16,0.563,1,4,0.25,8,12,0.667,0.594,3,6,0.5,4,13,17,2,1,2,2,1,22
2016,Devin Booker\bookede01,SG,20,PHO,78,78,2730,606,1431,0.423,147,405,0.363,459,1026,0.447,0.475,367,441,0.832,46,203,249,268,72,21,241,242,1726
2016,Trevor Booker\booketr01,PF,29,BRK,71,43,1754,305,591,0.516,25,78,0.321,280,513,0.546,0.537,74,110,0.673,143,428,571,138,75,28,127,152,709
2016,Avery Bradley\bradlav01,SG,26,BOS,55,55,1835,359,775,0.463,108,277,0.39,251,498,0.504,0.533,68,93,0.731,65,269,334,122,68,11,88,141,894
2016,Corey Brewer\breweco01,SF,30,TOT,82,11,1281,147,348,0.422,27,118,0.229,120,230,0.522,0.461,50,68,0.735,32,134,166,97,61,20,55,133,371
2016,Corey Brewer\breweco01,SF,30,HOU,58,8,923,94,227,0.414,22,94,0.234,72,133,0.541,0.463,32,44,0.727,21,93,114,61,37,12,36,104,242
2016,Corey Brewer\breweco01,SF,30,LAL,24,3,358,53,121,0.438,5,24,0.208,48,97,0.495,0.459,18,24,0.75,11,41,52,36,24,8,19,29,129
2016,Malcolm Brogdon\brogdma01,SG,24,MIL,75,28,1982,290,635,0.457,78,193,0.404,212,442,0.48,0.518,109,126,0.865,47,166,213,317,84,12,113,140,767
2016,Aaron Brooks\brookaa01,PG,32,IND,65,0,894,121,300,0.403,48,128,0.375,73,172,0.424,0.483,32,40,0.8,18,51,69,125,25,9,66,93,322
2016,Anthony Brown\brownan02,SF,24,TOT,11,0,159,18,50,0.36,7,27,0.259,11,23,0.478,0.43,0,0,,8,25,33,8,5,1,6,15,43
2016,Anthony Brown\brownan02,SF,24,NOP,9,0,143,14,41,0.341,6,24,0.25,8,17,0.471,0.415,0,0,,6,20,26,6,5,1,5,13,34
2016,Anthony Brown\brownan02,SF,24,ORL,2,0,16,4,9,0.444,1,3,0.333,3,6,0.5,0.5,0,0,,2,5,7,2,0,0,1,2,9
2016,Bobby Brown\brownbo02,PG,32,HOU,25,0,123,23,60,0.383,14,35,0.4,9,25,0.36,0.5,2,2,1,0,6,6,14,1,0,5,5,62
2016,Jaylen Brown\brownja02,SF,20,BOS,78,20,1341,192,423,0.454,46,135,0.341,146,288,0.507,0.508,85,124,0.685,45,175,220,64,35,18,68,142,515
2016,Nicolás Brussino\brussni01,SG,23,DAL,54,2,521,52,141,0.369,29,95,0.305,23,46,0.5,0.472,17,22,0.773,26,69,95,47,17,8,26,43,150
2016,Reggie Bullock\bullore01,SF,25,DET,31,5,467,54,128,0.422,28,73,0.384,26,55,0.473,0.531,5,7,0.714,13,51,64,29,18,3,10,22,141
2016,Trey Burke\burketr01,PG,24,WAS,57,0,703,116,255,0.455,31,70,0.443,85,185,0.459,0.516,22,29,0.759,7,40,47,100,11,5,48,54,285
2016,Alec Burks\burksal01,SG,25,UTA,42,0,653,99,248,0.399,25,76,0.329,74,172,0.43,0.45,60,78,0.769,17,103,120,30,18,5,35,50,283
2016,Jimmy Butler\butleji01,SF,27,CHI,76,75,2809,570,1252,0.455,91,248,0.367,479,1004,0.477,0.492,585,676,0.865,129,341,470,417,143,32,159,112,1816
2016,Bruno Caboclo\cabocbr01,SF,21,TOR,9,0,40,6,16,0.375,2,6,0.333,4,10,0.4,0.438,0,0,,5,5,10,4,2,1,2,4,14
2016,José Calderón\caldejo01,PG,35,TOT,41,13,539,55,134,0.41,20,64,0.313,35,70,0.5,0.485,11,12,0.917,15,59,74,88,11,1,41,36,141
2016,José Calderón\caldejo01,PG,35,LAL,24,11,292,32,77,0.416,12,34,0.353,20,43,0.465,0.494,4,4,1,8,34,42,51,7,1,26,22,80
2016,José Calderón\caldejo01,PG,35,ATL,17,2,247,23,57,0.404,8,30,0.267,15,27,0.556,0.474,7,8,0.875,7,25,32,37,4,0,15,14,61
2016,Kentavious Caldwell-Pope\caldwke01,SG,23,DET,76,75,2529,370,928,0.399,153,437,0.35,217,491,0.442,0.481,154,185,0.832,55,193,248,193,89,12,86,118,1047
2016,Isaiah Canaan\canaais01,SG,25,CHI,39,0,592,63,173,0.364,25,94,0.266,38,79,0.481,0.436,30,33,0.909,6,44,50,37,22,1,21,35,181
2016,Clint Capela\capelca01,C,22,HOU,65,59,1551,362,563,0.643,0,0,,362,563,0.643,0.643,94,177,0.531,178,348,526,63,34,79,87,179,818
2016,DeMarre Carroll\carrode01,SF,30,TOR,72,72,1882,220,550,0.4,109,320,0.341,111,230,0.483,0.499,89,117,0.761,63,212,275,74,81,27,54,143,638
2016,Vince Carter\cartevi01,SF,40,MEM,73,15,1799,193,490,0.394,112,296,0.378,81,194,0.418,0.508,88,115,0.765,36,191,227,133,60,36,50,163,586
2016,Michael Carter-Williams\cartemi01,PG,25,CHI,45,19,846,112,306,0.366,15,64,0.234,97,242,0.401,0.391,58,77,0.753,24,129,153,113,38,23,66,102,297
2016,Omri Casspi\casspom01,PF,28,TOT,36,2,643,77,164,0.47,15,43,0.349,62,121,0.512,0.515,17,29,0.586,27,85,112,37,23,3,29,50,186
2016,Omri Casspi\casspom01,PF,28,SAC,22,2,397,53,117,0.453,11,29,0.379,42,88,0.477,0.5,12,21,0.571,20,70,90,26,10,1,17,23,129
2016,Omri Casspi\casspom01,PF,28,NOP,1,0,24,5,9,0.556,2,4,0.5,3,5,0.6,0.667,0,0,,1,1,2,0,0,0,2,3,12
2016,Omri Casspi\casspom01,PF,28,MIN,13,0,222,19,38,0.5,2,10,0.2,17,28,0.607,0.526,5,8,0.625,6,14,20,11,13,2,10,24,45
2016,Willie Cauley-Stein\caulewi01,C,23,SAC,75,21,1421,255,481,0.53,0,2,0,255,479,0.532,0.53,101,151,0.669,85,254,339,80,53,44,69,147,611
2016,Tyson Chandler\chandty01,C,34,PHO,47,46,1298,153,228,0.671,0,0,,153,228,0.671,0.671,91,124,0.734,153,386,539,30,33,24,65,126,397
2016,Wilson Chandler\chandwi01,SF,29,DEN,71,33,2197,433,939,0.461,110,326,0.337,323,613,0.527,0.52,141,194,0.727,103,357,460,141,51,30,114,172,1117
2016,Marquese Chriss\chrisma01,PF,19,PHO,82,75,1743,284,632,0.449,72,224,0.321,212,408,0.52,0.506,113,181,0.624,96,252,348,60,67,70,108,263,753
2016,Rakeem Christmas\chrisra01,PF,25,IND,29,0,219,19,43,0.442,0,0,,19,43,0.442,0.442,21,29,0.724,26,30,56,4,3,6,8,37,59
2016,Semaj Christon\chrisse01,PG,24,OKC,64,1,973,77,223,0.345,12,63,0.19,65,160,0.406,0.372,17,31,0.548,19,68,87,130,28,7,43,79,183
2016,Ian Clark\clarkia01,SG,25,GSW,77,0,1137,211,433,0.487,61,163,0.374,150,270,0.556,0.558,44,58,0.759,22,99,121,90,39,8,55,77,527
2016,Jordan Clarkson\clarkjo01,SG,24,LAL,82,19,2397,477,1071,0.445,117,356,0.329,360,715,0.503,0.5,134,168,0.798,49,197,246,213,88,8,164,150,1205
2016,Norris Cole\coleno01,PG,28,OKC,13,0,125,16,52,0.308,3,13,0.231,13,39,0.333,0.337,8,10,0.8,0,11,11,14,8,0,7,18,43
2016,Darren Collison\collida01,PG,29,SAC,68,64,2063,340,714,0.476,73,175,0.417,267,539,0.495,0.527,147,171,0.86,23,129,152,312,67,9,114,119,900
2016,Nick Collison\collini01,PF,36,OKC,20,0,128,14,23,0.609,0,1,0,14,22,0.636,0.609,5,8,0.625,9,22,31,12,2,2,4,17,33
2016,Mike Conley\conlemi01,PG,29,MEM,69,68,2292,464,1009,0.46,171,419,0.408,293,590,0.497,0.545,316,368,0.859,31,210,241,433,92,19,156,126,1415
2016,Pat Connaughton\connapa01,SG,24,POR,39,1,316,37,72,0.514,17,33,0.515,20,39,0.513,0.632,7,9,0.778,10,42,52,28,6,2,17,23,98
2016,Quinn Cook\cookqu01,PG,23,TOT,14,0,188,33,66,0.5,11,26,0.423,22,40,0.55,0.583,2,5,0.4,1,6,7,26,4,0,13,13,79
2016,Quinn Cook\cookqu01,PG,23,DAL,5,0,77,11,25,0.44,5,14,0.357,6,11,0.545,0.54,0,2,0,0,3,3,12,1,0,8,6,27
2016,Quinn Cook\cookqu01,PG,23,NOP,9,0,111,22,41,0.537,6,12,0.5,16,29,0.552,0.61,2,3,0.667,1,3,4,14,3,0,5,7,52
2016,DeMarcus Cousins\couside01,C,26,TOT,72,72,2465,647,1432,0.452,131,363,0.361,516,1069,0.483,0.498,517,670,0.772,152,642,794,332,100,93,269,278,1942
2016,DeMarcus Cousins\couside01,C,26,SAC,55,55,1891,505,1118,0.452,95,267,0.356,410,851,0.482,0.494,423,549,0.77,115,468,583,266,75,74,207,203,1528
2016,DeMarcus Cousins\couside01,C,26,NOP,17,17,574,142,314,0.452,36,96,0.375,106,218,0.486,0.51,94,121,0.777,37,174,211,66,25,19,62,75,414
2016,Robert Covington\covinro01,SF,26,PHI,67,67,2119,292,732,0.399,137,412,0.333,155,320,0.484,0.492,143,174,0.822,92,344,436,102,127,69,131,203,864
2016,Allen Crabbe\crabbal01,SG,24,POR,79,7,2254,303,647,0.468,134,302,0.444,169,345,0.49,0.572,105,124,0.847,19,207,226,94,54,20,62,171,845
2016,Jamal Crawford\crawfja01,SG,36,LAC,82,1,2157,359,870,0.413,116,322,0.36,243,548,0.443,0.479,174,203,0.857,17,112,129,214,61,14,134,115,1008
2016,Jordan Crawford\crawfjo02,SG,28,NOP,19,0,442,105,218,0.482,37,95,0.389,68,123,0.553,0.567,20,26,0.769,4,30,34,57,11,2,25,30,267
2016,Jae Crowder\crowdja01,SF,26,BOS,72,72,2335,333,720,0.463,157,394,0.398,176,326,0.54,0.572,176,217,0.811,48,367,415,155,73,23,80,161,999
2016,Dante Cunningham\cunnida01,PF,29,NOP,66,35,1649,174,359,0.485,71,181,0.392,103,178,0.579,0.584,16,27,0.593,56,221,277,37,39,28,28,100,435
2016,Seth Curry\curryse01,PG,26,DAL,70,42,2029,338,703,0.481,137,322,0.425,201,381,0.528,0.578,85,100,0.85,25,154,179,189,79,7,92,126,898
2016,Stephen Curry\curryst01,PG,28,GSW,79,79,2638,675,1443,0.468,324,789,0.411,351,654,0.537,0.58,325,362,0.898,61,292,353,524,142,17,239,183,1999
2016,Troy Daniels\danietr01,SG,25,MEM,67,3,1183,185,495,0.374,138,355,0.389,47,140,0.336,0.513,43,54,0.796,22,78,100,46,20,4,45,90,551
2016,Anthony Davis\davisan02,C,23,NOP,75,75,2708,770,1526,0.505,40,134,0.299,730,1392,0.524,0.518,519,647,0.802,172,712,884,157,94,167,181,168,2099
2016,Deyonta Davis\davisde01,C,20,MEM,36,0,238,24,47,0.511,0,0,,24,47,0.511,0.511,10,18,0.556,20,40,60,2,3,17,8,40,58
2016,Ed Davis\davised01,PF,27,POR,46,12,789,75,142,0.528,0,0,,75,142,0.528,0.528,50,81,0.617,96,148,244,26,15,22,37,137,200
2016,Dewayne Dedmon\dedmode01,C,27,SAS,76,37,1330,161,259,0.622,0,0,,161,259,0.622,0.622,65,93,0.699,129,367,496,44,37,61,61,180,387
2016,Sam Dekker\dekkesa01,PF,22,HOU,77,2,1419,203,429,0.473,60,187,0.321,143,242,0.591,0.543,38,68,0.559,94,190,284,76,38,21,41,83,504
2016,Malcolm Delaney\delanma01,PG,27,ATL,73,2,1248,145,388,0.374,26,110,0.236,119,278,0.428,0.407,75,93,0.806,10,113,123,193,39,1,95,112,391
2016,Matthew Dellavedova\dellama01,PG,26,MIL,76,54,1986,208,534,0.39,79,215,0.367,129,319,0.404,0.463,82,96,0.854,24,123,147,357,53,0,133,153,577
2016,Luol Deng\denglu01,SF,31,LAL,56,49,1486,164,424,0.387,51,165,0.309,113,259,0.436,0.447,46,63,0.73,63,232,295,74,48,20,43,61,425
2016,DeMar DeRozan\derozde01,SG,27,TOR,74,74,2620,721,1545,0.467,33,124,0.266,688,1421,0.484,0.477,545,647,0.842,70,316,386,290,78,13,180,134,2020
2016,Cheick Diallo\diallch01,PF,20,NOP,17,0,199,36,76,0.474,0,0,,36,76,0.474,0.474,15,21,0.714,23,50,73,4,4,7,7,17,87
2016,Boris Diaw\diawbo01,PF,34,UTA,73,33,1283,146,327,0.446,20,81,0.247,126,246,0.512,0.477,26,35,0.743,46,112,158,170,18,9,87,83,338
2016,Gorgui Dieng\dienggo01,PF,27,MIN,82,82,2653,332,661,0.502,16,43,0.372,316,618,0.511,0.514,136,167,0.814,188,459,647,158,88,95,107,254,816
2016,Spencer Dinwiddie\dinwisp01,PG,23,BRK,59,18,1334,134,302,0.444,38,101,0.376,96,201,0.478,0.507,126,159,0.792,27,137,164,185,44,23,66,119,432
2016,Toney Douglas\douglto01,PG,30,MEM,24,0,394,43,117,0.368,7,42,0.167,36,75,0.48,0.397,24,29,0.828,13,48,61,56,18,5,21,50,117
2016,Goran Dragić\dragigo01,PG,30,MIA,73,73,2459,534,1124,0.475,117,289,0.405,417,835,0.499,0.527,298,377,0.79,62,217,279,423,89,13,212,199,1483
2016,Andre Drummond\drumman01,C,23,DET,81,81,2409,483,911,0.53,2,7,0.286,481,904,0.532,0.531,137,355,0.386,345,770,1115,90,124,89,152,237,1105
2016,Jared Dudley\dudleja01,PF,31,PHO,64,7,1362,157,346,0.454,77,203,0.379,80,143,0.559,0.565,43,65,0.662,31,194,225,121,42,16,73,154,434
2016,Mike Dunleavy\dunlemi02,SF,36,TOT,53,2,841,93,220,0.423,53,134,0.396,40,86,0.465,0.543,36,45,0.8,18,97,115,50,15,7,28,67,275
2016,Mike Dunleavy\dunlemi02,SF,36,CLE,23,2,366,36,90,0.4,20,57,0.351,16,33,0.485,0.511,14,19,0.737,5,42,47,20,6,2,14,32,106
2016,Mike Dunleavy\dunlemi02,SF,36,ATL,30,0,475,57,130,0.438,33,77,0.429,24,53,0.453,0.565,22,26,0.846,13,55,68,30,9,5,14,35,169
2016,Kris Dunn\dunnkr01,PG,22,MIN,78,7,1333,118,313,0.377,21,73,0.288,97,240,0.404,0.411,36,59,0.61,24,142,166,188,78,36,89,178,293
2016,Kevin Durant\duranke01,PF,28,GSW,62,62,2070,551,1026,0.537,117,312,0.375,434,714,0.608,0.594,336,384,0.875,39,474,513,300,66,99,138,117,1555
2016,Jarell Eddie\eddieja01,SF,25,PHO,5,0,62,6,19,0.316,4,16,0.25,2,3,0.667,0.421,8,9,0.889,1,6,7,0,1,0,1,1,24
2016,Henry Ellenson\ellenhe01,PF,20,DET,19,2,146,23,64,0.359,10,35,0.286,13,29,0.448,0.438,4,8,0.5,8,33,41,7,1,1,14,6,60
2016,Wayne Ellington\ellinwa01,SG,29,MIA,62,13,1500,231,555,0.416,149,394,0.378,82,161,0.509,0.55,37,43,0.86,18,114,132,70,35,4,30,70,648
2016,Monta Ellis\ellismo01,SG,31,IND,74,33,1998,247,557,0.443,43,135,0.319,204,422,0.483,0.482,93,128,0.727,19,185,204,236,78,27,135,149,630
2016,Joel Embiid\embiijo01,C,22,PHI,31,31,786,200,429,0.466,36,98,0.367,164,331,0.495,0.508,191,244,0.783,61,182,243,66,27,76,117,112,627
2016,James Ennis\ennisja01,SF,26,MEM,64,28,1501,146,321,0.455,51,137,0.372,95,184,0.516,0.534,86,110,0.782,69,190,259,64,46,19,59,165,429
2016,Tyler Ennis\ennisty01,PG,22,TOT,53,2,588,90,208,0.433,27,70,0.386,63,138,0.457,0.498,21,25,0.84,9,36,45,86,25,2,45,58,228
2016,Tyler Ennis\ennisty01,PG,22,HOU,31,0,196,25,64,0.391,6,16,0.375,19,48,0.396,0.438,2,3,0.667,4,15,19,34,6,0,24,29,58
2016,Tyler Ennis\ennisty01,PG,22,LAL,22,2,392,65,144,0.451,21,54,0.389,44,90,0.489,0.524,19,22,0.864,5,21,26,52,19,2,21,29,170
2016,Tyreke Evans\evansty01,SF,27,TOT,40,6,788,150,370,0.405,42,118,0.356,108,252,0.429,0.462,69,92,0.75,13,124,137,124,35,9,61,60,411
2016,Tyreke Evans\evansty01,SF,27,NOP,26,0,474,91,227,0.401,21,70,0.3,70,157,0.446,0.447,45,58,0.776,6,80,86,91,23,4,39,41,248
2016,Tyreke Evans\evansty01,SF,27,SAC,14,6,314,59,143,0.413,21,48,0.438,38,95,0.4,0.486,24,34,0.706,7,44,51,33,12,5,22,19,163
2016,Dante Exum\exumda01,PG,21,UTA,66,26,1228,155,363,0.427,44,149,0.295,111,214,0.519,0.488,58,73,0.795,30,102,132,111,21,12,80,146,412
2016,Kenneth Faried\farieke01,PF,27,DEN,61,34,1296,228,416,0.548,0,6,0,228,410,0.556,0.548,131,189,0.693,183,279,462,55,43,40,59,124,587
2016,Jordan Farmar\farmajo01,PG,30,SAC,2,0,35,4,12,0.333,4,9,0.444,0,3,0,0.5,0,0,,1,2,3,9,2,0,3,1,12
2016,Derrick Favors\favorde01,PF,25,UTA,50,39,1186,203,417,0.487,3,10,0.3,200,407,0.491,0.49,67,109,0.615,92,213,305,56,45,40,60,103,476
2016,Kay Felder\feldeka01,PG,21,CLE,42,0,386,62,158,0.392,7,22,0.318,55,136,0.404,0.415,35,49,0.714,3,38,41,58,18,7,30,38,166
2016,Cristiano Felício\feliccr01,C,24,CHI,66,0,1040,128,221,0.579,0,0,,128,221,0.579,0.579,60,93,0.645,124,187,311,40,25,17,33,110,316
2016,Raymond Felton\feltora01,PG,32,LAC,80,11,1700,221,514,0.43,46,144,0.319,175,370,0.473,0.475,50,64,0.781,33,185,218,191,66,22,83,125,538
2016,Yogi Ferrell\ferreyo01,PG,23,TOT,46,29,1197,160,394,0.406,68,176,0.386,92,218,0.422,0.492,74,89,0.831,20,91,111,172,42,9,70,90,462
2016,Yogi Ferrell\ferreyo01,PG,23,BRK,10,0,151,18,49,0.367,8,27,0.296,10,22,0.455,0.449,10,16,0.625,4,8,12,17,2,2,14,11,54
2016,Yogi Ferrell\ferreyo01,PG,23,DAL,36,29,1046,142,345,0.412,60,149,0.403,82,196,0.418,0.499,64,73,0.877,16,83,99,155,40,7,56,79,408
2016,Dorian Finney-Smith\finnedo01,PF,23,DAL,81,35,1642,124,333,0.372,56,191,0.293,68,142,0.479,0.456,46,61,0.754,55,167,222,67,52,25,45,125,350
2016,Bryn Forbes\forbebr01,SG,23,SAS,36,0,285,36,99,0.364,17,53,0.321,19,46,0.413,0.449,5,6,0.833,2,21,23,23,1,0,11,20,94
2016,Evan Fournier\fournev01,SG,24,ORL,68,66,2234,408,930,0.439,128,360,0.356,280,570,0.491,0.508,223,277,0.805,44,165,209,202,66,4,141,180,1167
2016,Randy Foye\foyera01,SG,33,BRK,69,40,1284,118,325,0.363,67,203,0.33,51,122,0.418,0.466,54,63,0.857,9,146,155,135,35,9,80,99,357
2016,Tim Frazier\fraziti01,PG,26,NOP,65,35,1525,163,404,0.403,40,128,0.313,123,276,0.446,0.453,98,129,0.76,34,139,173,335,56,6,101,133,464
2016,Channing Frye\fryech01,C,33,CLE,74,15,1398,238,520,0.458,137,335,0.409,101,185,0.546,0.589,63,74,0.851,37,253,290,45,33,37,53,138,676
2016,Danilo Gallinari\gallida01,SF,28,DEN,63,63,2134,335,750,0.447,126,324,0.389,209,426,0.491,0.531,349,387,0.902,39,286,325,135,40,15,82,93,1145
2016,Langston Galloway\gallola01,PG,25,TOT,74,2,1495,207,545,0.38,120,308,0.39,87,237,0.367,0.49,51,64,0.797,27,129,156,93,46,6,46,96,585
2016,Langston Galloway\gallola01,PG,25,NOP,55,0,1120,165,441,0.374,101,268,0.377,64,173,0.37,0.489,40,52,0.769,20,101,121,65,40,5,28,76,471
2016,Langston Galloway\gallola01,PG,25,SAC,19,2,375,42,104,0.404,19,40,0.475,23,64,0.359,0.495,11,12,0.917,7,28,35,28,6,1,18,20,114
2016,Patricio Garino\garinpa01,SG,23,ORL,5,0,43,0,7,0,0,5,0,0,2,0,0,0,0,,1,6,7,0,0,0,3,4,0
2016,Marc Gasol\gasolma01,C,32,MEM,74,74,2531,532,1160,0.459,104,268,0.388,428,892,0.48,0.503,278,332,0.837,60,404,464,338,67,99,166,171,1446
2016,Pau Gasol\gasolpa01,C,36,SAS,64,39,1627,303,604,0.502,56,104,0.538,247,500,0.494,0.548,130,184,0.707,107,394,501,150,24,70,81,110,792
2016,Rudy Gay\gayru01,SF,30,SAC,30,30,1013,201,442,0.455,42,113,0.372,159,329,0.483,0.502,118,138,0.855,35,155,190,83,44,26,74,79,562
2016,Michael Gbinije\gbinimi01,SG,24,DET,9,0,32,1,10,0.1,0,4,0,1,6,0.167,0.1,2,2,1,2,1,3,2,0,0,0,2,4
2016,Alonzo Gee\geeal01,SF,29,DEN,13,0,89,3,14,0.214,0,3,0,3,11,0.273,0.214,5,9,0.556,4,11,15,6,5,1,4,14,11
2016,Paul George\georgpa01,SF,26,IND,75,75,2689,622,1348,0.461,195,496,0.393,427,852,0.501,0.534,336,374,0.898,58,434,492,251,119,27,220,206,1775
2016,Marcus Georges-Hunt\georgma01,SG,22,ORL,5,0,48,2,7,0.286,1,2,0.5,1,5,0.2,0.357,9,10,0.9,1,8,9,3,1,0,2,5,14
2016,Jonathan Gibson\gibsojo01,PG,29,DAL,17,0,231,35,95,0.368,15,45,0.333,20,50,0.4,0.447,21,29,0.724,1,21,22,26,8,0,21,21,106
2016,Taj Gibson\gibsota01,PF,31,TOT,78,71,1989,365,709,0.515,3,13,0.231,362,696,0.52,0.517,113,158,0.715,158,327,485,73,41,65,105,163,846
2016,Taj Gibson\gibsota01,PF,31,CHI,55,55,1502,276,530,0.521,2,12,0.167,274,518,0.529,0.523,85,119,0.714,120,262,382,60,27,50,77,123,639
2016,Taj Gibson\gibsota01,PF,31,OKC,23,16,487,89,179,0.497,1,1,1,88,178,0.494,0.5,28,39,0.718,38,65,103,13,14,15,28,40,207
2016,Manu Ginóbili\ginobma01,SG,39,SAS,69,0,1291,171,439,0.39,89,227,0.392,82,212,0.387,0.491,86,107,0.804,28,129,157,183,82,16,96,119,517
2016,Rudy Gobert\goberru01,C,24,UTA,81,81,2744,413,625,0.661,0,1,0,413,624,0.662,0.661,311,476,0.653,314,721,1035,97,49,214,147,246,1137
2016,Archie Goodwin\goodwar01,SG,22,TOT,15,0,214,36,66,0.545,5,15,0.333,31,51,0.608,0.583,33,42,0.786,7,21,28,24,4,5,14,8,110
2016,Archie Goodwin\goodwar01,SG,22,NOP,3,0,30,2,5,0.4,1,2,0.5,1,3,0.333,0.5,10,10,1,0,0,0,1,0,1,0,1,15
2016,Archie Goodwin\goodwar01,SG,22,BRK,12,0,184,34,61,0.557,4,13,0.308,30,48,0.625,0.59,23,32,0.719,7,21,28,23,4,4,14,7,95
2016,Aaron Gordon\gordoaa01,SF,21,ORL,80,72,2298,393,865,0.454,77,267,0.288,316,598,0.528,0.499,156,217,0.719,116,289,405,150,65,40,89,172,1019
2016,Eric Gordon\gordoer01,SG,28,HOU,75,15,2323,412,1016,0.406,246,661,0.372,166,355,0.468,0.527,147,175,0.84,29,172,201,188,48,41,121,150,1217
2016,Marcin Gortat\gortama01,C,32,WAS,82,82,2556,390,674,0.579,0,2,0,390,672,0.58,0.579,103,159,0.648,238,611,849,121,40,61,119,213,883
2016,Treveon Graham\grahatr01,SG,23,CHO,27,1,189,19,40,0.475,9,15,0.6,10,25,0.4,0.588,10,15,0.667,5,17,22,6,6,1,3,18,57
2016,Jerami Grant\grantje01,PF,22,TOT,80,4,1531,152,328,0.463,43,116,0.371,109,212,0.514,0.529,90,147,0.612,38,167,205,46,33,79,44,149,437
2016,Jerami Grant\grantje01,PF,22,PHI,2,0,41,6,17,0.353,0,2,0,6,15,0.4,0.353,4,8,0.5,0,6,6,0,0,4,3,5,16
2016,Jerami Grant\grantje01,PF,22,OKC,78,4,1490,146,311,0.469,43,114,0.377,103,197,0.523,0.539,86,139,0.619,38,161,199,46,33,75,41,144,421
2016,Jerian Grant\grantje02,PG,24,CHI,63,28,1028,128,301,0.425,49,134,0.366,79,167,0.473,0.507,65,73,0.89,17,94,111,121,47,8,44,93,370
2016,Danny Green\greenda02,SG,29,SAS,68,68,1807,176,449,0.392,118,311,0.379,58,138,0.42,0.523,27,32,0.844,31,193,224,124,70,57,76,120,497
2016,Draymond Green\greendr01,PF,26,GSW,76,76,2471,272,650,0.418,81,263,0.308,191,387,0.494,0.481,151,213,0.709,98,501,599,533,154,106,184,217,776
2016,Gerald Green\greenge01,SF,31,BOS,47,0,538,95,232,0.409,39,111,0.351,56,121,0.463,0.494,33,41,0.805,16,68,84,33,9,7,25,48,262
2016,JaMychal Green\greenja01,PF,26,MEM,77,75,2101,250,500,0.5,55,145,0.379,195,355,0.549,0.555,134,167,0.802,167,377,544,84,47,34,94,248,689
2016,Jeff Green\greenje02,PF,30,ORL,69,11,1534,220,558,0.394,53,193,0.275,167,365,0.458,0.442,145,168,0.863,39,175,214,81,37,13,75,103,638
2016,Blake Griffin\griffbl01,PF,27,LAC,61,61,2076,479,971,0.493,38,113,0.336,441,858,0.514,0.513,320,421,0.76,112,385,497,300,57,22,142,157,1316
2016,Justin Hamilton\hamilju01,C,26,BRK,64,7,1177,174,379,0.459,55,180,0.306,119,199,0.598,0.532,39,52,0.75,71,191,262,55,29,43,43,91,442
2016,A.J. Hammons\hammoaj01,C,24,DAL,22,0,163,17,42,0.405,5,10,0.5,12,32,0.375,0.464,9,20,0.45,8,28,36,4,1,13,10,21,48
2016,Tim Hardaway Jr.\hardati02,SG,24,ATL,79,30,2154,415,912,0.455,149,417,0.357,266,495,0.537,0.537,164,214,0.766,35,189,224,182,55,15,106,103,1143
2016,James Harden\hardeja01,PG,27,HOU,81,81,2947,674,1533,0.44,262,756,0.347,412,777,0.53,0.525,746,881,0.847,95,564,659,907,121,38,464,215,2356
2016,Maurice Harkless\harklma01,SF,23,POR,77,69,2223,314,624,0.503,68,194,0.351,246,430,0.572,0.558,77,124,0.621,125,216,341,88,85,70,86,214,773
2016,Justin Harper\harpeju01,PF,27,PHI,3,0,31,5,12,0.417,2,7,0.286,3,5,0.6,0.5,0,0,,2,3,5,2,0,0,4,2,12
2016,Montrezl Harrell\harremo01,C,23,HOU,58,14,1064,225,345,0.652,1,7,0.143,224,338,0.663,0.654,76,121,0.628,81,138,219,64,20,42,44,126,527
2016,Devin Harris\harride01,PG,33,DAL,65,0,1087,136,341,0.399,58,177,0.328,78,164,0.476,0.484,107,129,0.829,11,116,127,136,43,7,57,101,437
2016,Gary Harris\harriga01,SG,22,DEN,57,56,1782,320,637,0.502,107,255,0.42,213,382,0.558,0.586,104,134,0.776,48,130,178,164,71,8,76,92,851
2016,Joe Harris\harrijo01,SG,25,BRK,52,11,1138,154,362,0.425,85,221,0.385,69,141,0.489,0.543,35,49,0.714,16,131,147,54,30,8,55,121,428
2016,Manny Harris\harrima01,SG,27,DAL,4,0,25,3,15,0.2,0,2,0,3,13,0.231,0.2,2,4,0.5,3,6,9,2,0,0,2,1,8
2016,Tobias Harris\harrito02,PF,24,DET,82,48,2567,511,1063,0.481,109,314,0.347,402,749,0.537,0.532,190,226,0.841,63,353,416,142,60,39,96,133,1321
2016,Aaron Harrison\harriaa01,SG,22,CHO,5,0,17,0,4,0,0,2,0,0,2,0,0,1,2,0.5,0,3,3,3,0,0,0,2,1
2016,Andrew Harrison\harrian01,PG,22,MEM,72,18,1474,117,360,0.325,43,156,0.276,74,204,0.363,0.385,148,194,0.763,23,113,136,198,53,21,85,194,425
2016,Udonis Haslem\hasleud01,C,36,MIA,16,0,130,11,23,0.478,0,3,0,11,20,0.55,0.478,9,15,0.6,8,28,36,6,6,1,8,22,31
2016,Spencer Hawes\hawessp01,PF,28,TOT,54,1,797,134,277,0.484,25,81,0.309,109,196,0.556,0.529,44,52,0.846,38,153,191,81,15,30,49,77,337
2016,Spencer Hawes\hawessp01,PF,28,CHO,35,1,626,104,218,0.477,16,55,0.291,88,163,0.54,0.514,30,34,0.882,32,114,146,62,13,26,40,61,254
2016,Spencer Hawes\hawessp01,PF,28,MIL,19,0,171,30,59,0.508,9,26,0.346,21,33,0.636,0.585,14,18,0.778,6,39,45,19,2,4,9,16,83
2016,Gordon Hayward\haywago01,SF,26,UTA,73,73,2516,545,1156,0.471,149,374,0.398,396,782,0.506,0.536,362,429,0.844,49,345,394,252,73,20,140,117,1601
2016,Gerald Henderson\hendege02,SG,29,PHI,72,41,1667,234,553,0.423,61,173,0.353,173,380,0.455,0.478,133,165,0.806,34,151,185,112,40,15,62,129,662
2016,John Henson\hensojo01,C,26,MIL,58,39,1123,159,309,0.515,0,1,0,159,308,0.516,0.515,74,107,0.692,92,203,295,57,29,78,52,151,392
2016,Juan Hernangómez\hernaju01,PF,21,DEN,62,9,842,101,224,0.451,46,113,0.407,55,111,0.495,0.554,57,76,0.75,43,144,187,29,30,12,31,62,305
2016,Willy Hernangómez\hernawi01,C,22,NYK,72,22,1324,246,465,0.529,4,15,0.267,242,450,0.538,0.533,91,125,0.728,170,332,502,96,41,36,100,150,587
2016,Mario Hezonja\hezonma01,SF,21,ORL,65,2,960,117,330,0.355,43,144,0.299,74,186,0.398,0.42,40,50,0.8,20,126,146,62,30,15,58,74,317
2016,Roy Hibbert\hibbero01,C,30,TOT,48,13,682,80,147,0.544,0,0,,80,147,0.544,0.544,61,75,0.813,54,98,152,21,8,46,32,100,221
2016,Roy Hibbert\hibbero01,C,30,CHO,42,13,671,78,144,0.542,0,0,,78,144,0.542,0.542,61,75,0.813,53,97,150,20,8,44,31,97,217
2016,Roy Hibbert\hibbero01,C,30,DEN,6,0,11,2,3,0.667,0,0,,2,3,0.667,0.667,0,0,,1,1,2,1,0,2,1,3,4
2016,Buddy Hield\hieldbu01,SG,24,TOT,82,55,1888,327,767,0.426,148,379,0.391,179,388,0.461,0.523,64,76,0.842,35,234,269,121,38,9,101,115,866
2016,Buddy Hield\hieldbu01,SG,24,NOP,57,37,1161,185,471,0.393,89,241,0.369,96,230,0.417,0.487,29,33,0.879,19,147,166,77,18,7,48,81,488
2016,Buddy Hield\hieldbu01,SG,24,SAC,25,18,727,142,296,0.48,59,138,0.428,83,158,0.525,0.579,35,43,0.814,16,87,103,44,20,2,53,34,378
2016,Nenê\hilarne01,C,34,HOU,67,8,1198,245,397,0.617,3,9,0.333,242,388,0.624,0.621,116,197,0.589,95,187,282,65,56,39,73,163,609
2016,George Hill\hillge01,PG,30,UTA,49,49,1544,289,606,0.477,94,233,0.403,195,373,0.523,0.554,157,196,0.801,23,144,167,204,50,11,85,114,829
2016,Jordan Hill\hilljo01,C,29,MIN,7,0,47,5,13,0.385,0,0,,5,13,0.385,0.385,2,2,1,8,6,14,0,1,0,4,9,12
2016,Solomon Hill\hillso01,SF,25,NOP,80,71,2374,183,478,0.383,94,270,0.348,89,208,0.428,0.481,103,128,0.805,51,256,307,141,72,32,82,182,563
2016,Darrun Hilliard\hillida01,SG,23,DET,39,1,381,47,126,0.373,12,46,0.261,35,80,0.438,0.421,21,28,0.75,2,31,33,33,11,2,28,39,127
2016,Jrue Holiday\holidjr01,PG,26,NOP,67,61,2190,405,893,0.454,100,281,0.356,305,612,0.498,0.51,119,168,0.708,46,218,264,488,100,44,194,133,1029
2016,Justin Holiday\holidju01,SG,27,NYK,82,4,1639,233,538,0.433,97,273,0.355,136,265,0.513,0.523,66,80,0.825,27,198,225,102,65,31,66,109,629
2016,Rondae Hollis-Jefferson\holliro01,SF,22,BRK,78,50,1761,235,542,0.434,15,67,0.224,220,475,0.463,0.447,190,253,0.751,96,356,452,154,82,44,116,177,675
2016,Richaun Holmes\holmeri01,C,23,PHI,57,17,1193,230,412,0.558,27,77,0.351,203,335,0.606,0.591,72,103,0.699,94,217,311,58,42,55,55,136,559
2016,Rodney Hood\hoodro01,SG,24,UTA,59,55,1593,272,666,0.408,114,307,0.371,158,359,0.44,0.494,90,115,0.783,16,186,202,96,38,11,65,132,748
2016,Al Horford\horfoal01,C,30,BOS,68,68,2193,379,801,0.473,86,242,0.355,293,559,0.524,0.527,108,135,0.8,95,370,465,337,52,86,115,138,952
2016,Danuel House\houseda01,SG,23,WAS,1,0,1,0,0,,0,0,,0,0,,,0,0,,0,1,1,0,0,0,0,0,0
2016,Dwight Howard\howardw01,C,31,ATL,74,74,2199,388,613,0.633,0,2,0,388,611,0.635,0.633,226,424,0.533,296,644,940,104,64,92,170,203,1002
2016,Marcelo Huertas\huertma01,PG,33,LAL,23,1,237,25,68,0.368,4,19,0.211,21,49,0.429,0.397,9,17,0.529,2,22,24,52,10,2,19,16,63
2016,Josh Huestis\huestjo01,PF,25,OKC,2,0,31,6,11,0.545,2,4,0.5,4,7,0.571,0.636,0,1,0,4,5,9,3,0,3,0,0,14
2016,Kris Humphries\humphkr01,PF,31,ATL,56,4,689,87,214,0.407,19,54,0.352,68,160,0.425,0.451,64,82,0.78,60,146,206,29,15,21,28,69,257
2016,R.J. Hunter\hunterj01,SG,23,CHI,3,0,9,0,1,0,0,1,0,0,0,,0,0,0,,0,1,1,0,0,0,0,0,0
2016,Serge Ibaka\ibakase01,PF,27,TOT,79,79,2422,471,982,0.48,124,317,0.391,347,665,0.522,0.543,107,125,0.856,129,409,538,75,41,124,105,215,1173
2016,Serge Ibaka\ibakase01,PF,27,ORL,56,56,1710,343,703,0.488,83,214,0.388,260,489,0.532,0.547,77,91,0.846,100,282,382,60,34,91,66,139,846
2016,Serge Ibaka\ibakase01,PF,27,TOR,23,23,712,128,279,0.459,41,103,0.398,87,176,0.494,0.532,30,34,0.882,29,127,156,15,7,33,39,76,327
2016,Andre Iguodala\iguodan01,SF,33,GSW,76,0,1998,219,415,0.528,64,177,0.362,155,238,0.651,0.605,72,102,0.706,51,253,304,261,76,39,58,97,574
2016,Ersan İlyasova\ilyaser01,PF,29,TOT,82,52,2142,384,890,0.431,142,402,0.353,242,488,0.496,0.511,161,207,0.778,115,366,481,141,58,23,116,211,1071
2016,Ersan İlyasova\ilyaser01,PF,29,OKC,3,0,62,6,16,0.375,3,12,0.25,3,4,0.75,0.469,0,0,,2,14,16,1,3,1,4,5,15
2016,Ersan İlyasova\ilyaser01,PF,29,PHI,53,40,1447,285,648,0.44,107,298,0.359,178,350,0.509,0.522,109,142,0.768,71,243,314,97,33,14,78,133,786
2016,Ersan İlyasova\ilyaser01,PF,29,ATL,26,12,633,93,226,0.412,32,92,0.348,61,134,0.455,0.482,52,65,0.8,42,109,151,43,22,8,34,73,270
2016,Joe Ingles\inglejo01,SF,29,UTA,82,26,1972,204,451,0.452,123,279,0.441,81,172,0.471,0.589,50,68,0.735,23,238,261,225,96,8,107,163,581
2016,Brandon Ingram\ingrabr01,SF,19,LAL,79,40,2279,276,686,0.402,55,187,0.294,221,499,0.443,0.442,133,214,0.621,60,256,316,166,50,36,116,158,740
2016,Kyrie Irving\irvinky01,PG,24,CLE,72,72,2525,671,1420,0.473,177,441,0.401,494,979,0.505,0.535,297,328,0.905,52,178,230,418,83,24,180,157,1816
2016,Jarrett Jack\jackja01,PG,33,NOP,2,0,33,2,3,0.667,0,1,0,2,2,1,0.667,2,2,1,0,0,0,5,2,0,3,4,6
2016,Demetrius Jackson\jacksde01,PG,22,BOS,5,0,17,3,4,0.75,1,1,1,2,3,0.667,0.875,3,6,0.5,2,2,4,3,0,0,0,0,10
2016,Pierre Jackson\jackspi01,PG,25,DAL,8,1,84,13,39,0.333,3,11,0.273,10,28,0.357,0.372,6,7,0.857,1,8,9,19,2,0,3,5,35
2016,Reggie Jackson\jacksre01,PG,26,DET,52,50,1424,284,677,0.419,66,184,0.359,218,493,0.442,0.468,118,136,0.868,21,93,114,270,35,5,114,129,752
2016,LeBron James\jamesle01,SF,32,CLE,74,74,2794,736,1344,0.548,124,342,0.363,612,1002,0.611,0.594,358,531,0.674,97,542,639,646,92,44,303,134,1954
2016,Al Jefferson\jeffeal01,C,32,IND,66,1,931,235,471,0.499,0,1,0,235,470,0.5,0.499,65,85,0.765,75,203,278,57,19,16,33,125,535
2016,Richard Jefferson\jefferi01,SF,36,CLE,79,13,1614,153,343,0.446,62,186,0.333,91,157,0.58,0.536,80,108,0.741,28,175,203,78,26,10,52,153,448
2016,John Jenkins\jenkijo01,SG,25,PHO,4,0,13,2,5,0.4,1,2,0.5,1,3,0.333,0.5,2,2,1,0,1,1,1,0,0,0,0,7
2016,Brandon Jennings\jennibr01,PG,27,TOT,81,13,1802,192,535,0.359,79,252,0.313,113,283,0.399,0.433,114,152,0.75,29,167,196,395,70,4,128,116,577
2016,Brandon Jennings\jennibr01,PG,27,NYK,58,11,1428,163,429,0.38,68,200,0.34,95,229,0.415,0.459,102,135,0.756,21,131,152,287,55,4,106,84,496
2016,Brandon Jennings\jennibr01,PG,27,WAS,23,2,374,29,106,0.274,11,52,0.212,18,54,0.333,0.325,12,17,0.706,8,36,44,108,15,0,22,32,81
2016,Jonas Jerebko\jerebjo01,PF,29,BOS,78,6,1232,114,262,0.435,45,130,0.346,69,132,0.523,0.521,26,37,0.703,59,213,272,71,25,17,39,122,299
2016,Amir Johnson\johnsam01,PF,29,BOS,80,77,1608,213,370,0.576,27,66,0.409,186,304,0.612,0.612,67,100,0.67,118,248,366,140,51,62,77,211,520
2016,Brice Johnson\johnsbr02,PF,22,LAC,3,0,9,2,7,0.286,0,0,,2,7,0.286,0.286,0,0,,1,2,3,1,2,1,1,0,4
2016,James Johnson\johnsja01,PF,29,MIA,76,5,2085,368,769,0.479,87,256,0.34,281,513,0.548,0.535,152,215,0.707,66,310,376,276,76,86,171,197,975
2016,Joe Johnson\johnsjo02,SF,35,UTA,78,14,1843,273,626,0.436,106,258,0.411,167,368,0.454,0.521,63,77,0.818,33,210,243,144,36,18,69,93,715
2016,Stanley Johnson\johnsst04,SF,20,DET,77,1,1371,129,365,0.353,45,154,0.292,84,211,0.398,0.415,36,53,0.679,36,153,189,105,56,24,71,121,339
2016,Tyler Johnson\johnsty01,PG,24,MIA,73,0,2178,357,824,0.433,93,250,0.372,264,574,0.46,0.49,195,254,0.768,50,243,293,233,84,44,90,176,1002
2016,Wesley Johnson\johnswe01,SF,29,LAC,68,3,810,73,200,0.365,29,118,0.246,44,82,0.537,0.438,11,17,0.647,26,155,181,23,29,30,18,83,186
2016,Nikola Jokić\jokicni01,C,21,DEN,73,59,2038,494,854,0.578,45,139,0.324,449,715,0.628,0.605,188,228,0.825,212,506,718,359,61,55,171,214,1221
2016,Dahntay Jones\jonesda02,SF,36,CLE,1,0,12,3,8,0.375,0,2,0,3,6,0.5,0.375,3,4,0.75,1,1,2,1,0,0,1,1,9
2016,Damian Jones\jonesda03,C,21,GSW,10,0,85,8,16,0.5,0,0,,8,16,0.5,0.5,3,10,0.3,9,14,23,0,1,4,6,15,19
2016,Derrick Jones Jr.\jonesde02,SF,19,PHO,32,8,545,68,121,0.562,3,11,0.273,65,110,0.591,0.574,29,41,0.707,39,40,79,12,14,13,13,63,168
2016,James Jones\jonesja02,SF,36,CLE,48,2,381,44,92,0.478,31,66,0.47,13,26,0.5,0.647,13,20,0.65,3,34,37,14,6,10,10,37,132
2016,Terrence Jones\joneste01,PF,25,TOT,54,12,1270,231,492,0.47,19,75,0.253,212,417,0.508,0.489,103,170,0.606,65,241,306,59,40,54,48,67,584
2016,Terrence Jones\joneste01,PF,25,NOP,51,12,1264,231,489,0.472,19,75,0.253,212,414,0.512,0.492,103,170,0.606,65,238,303,59,39,53,48,67,584
2016,Terrence Jones\joneste01,PF,25,MIL,3,0,6,0,3,0,0,0,,0,3,0,0,0,0,,0,3,3,0,1,1,0,0,0
2016,Tyus Jones\jonesty01,PG,20,MIN,60,0,774,75,181,0.414,26,73,0.356,49,108,0.454,0.486,33,43,0.767,10,57,67,156,48,5,38,50,209
2016,DeAndre Jordan\jordade01,C,28,LAC,81,81,2570,412,577,0.714,0,2,0,412,575,0.717,0.714,205,425,0.482,298,816,1114,96,51,134,115,212,1029
2016,Cory Joseph\josepco01,PG,25,TOR,80,22,2003,299,661,0.452,48,135,0.356,251,526,0.477,0.489,94,122,0.77,51,184,235,265,66,13,108,140,740
2016,Frank Kaminsky\kaminfr01,C,23,CHO,75,16,1954,320,802,0.399,116,354,0.328,204,448,0.455,0.471,118,156,0.756,57,279,336,162,46,34,76,139,874
2016,Enes Kanter\kanteen01,C,24,OKC,72,0,1533,402,737,0.545,5,38,0.132,397,699,0.568,0.549,224,285,0.786,195,287,482,67,32,38,123,154,1033
2016,Ryan Kelly\kellyry01,PF,25,ATL,16,0,110,8,28,0.286,4,10,0.4,4,18,0.222,0.357,5,6,0.833,1,17,18,8,4,5,4,5,25
2016,Michael Kidd-Gilchrist\kiddgmi01,SF,23,CHO,81,81,2349,295,618,0.477,1,9,0.111,294,609,0.483,0.478,152,194,0.784,156,409,565,114,81,77,56,187,743
2016,Sean Kilpatrick\kilpase01,SG,27,BRK,70,24,1754,305,735,0.415,105,308,0.341,200,427,0.468,0.486,204,242,0.843,22,258,280,157,45,6,135,118,919
2016,Brandon Knight\knighbr03,SG,25,PHO,54,5,1140,209,525,0.398,45,139,0.324,164,386,0.425,0.441,132,154,0.857,25,93,118,130,27,5,88,87,595
2016,Kyle Korver\korveky01,SG,35,TOT,67,22,1753,239,515,0.464,162,359,0.451,77,156,0.494,0.621,38,42,0.905,7,179,186,110,34,21,69,107,678
2016,Kyle Korver\korveky01,SG,35,ATL,32,21,894,108,246,0.439,65,159,0.409,43,87,0.494,0.571,24,27,0.889,0,89,89,75,23,13,40,47,305
2016,Kyle Korver\korveky01,SG,35,CLE,35,1,859,131,269,0.487,97,200,0.485,34,69,0.493,0.667,14,15,0.933,7,90,97,35,11,8,29,60,373
2016,Kosta Koufos\koufoko01,C,27,SAC,71,62,1419,216,392,0.551,0,1,0,216,391,0.552,0.551,38,62,0.613,118,285,403,47,36,48,61,172,470
2016,Mindaugas Kuzminskas\kuzmimi01,SF,27,NYK,68,5,1016,158,369,0.428,54,168,0.321,104,201,0.517,0.501,55,68,0.809,47,79,126,69,29,11,51,79,425
2016,Skal Labissière\labissk01,PF,20,SAC,33,12,612,117,218,0.537,3,8,0.375,114,210,0.543,0.544,52,74,0.703,51,111,162,27,16,13,37,64,289
2016,Jeremy Lamb\lambje01,SG,24,CHO,62,5,1143,226,491,0.46,41,146,0.281,185,345,0.536,0.502,110,129,0.853,30,234,264,75,27,23,40,98,603
2016,Nicolás Laprovíttola\laproni01,PG,27,SAS,18,3,174,20,47,0.426,10,27,0.37,10,20,0.5,0.532,9,9,1,1,9,10,28,4,1,19,19,59
2016,Joffrey Lauvergne\lauvejo01,PF-C,25,TOT,70,1,980,148,336,0.44,33,98,0.337,115,238,0.483,0.49,46,73,0.63,72,179,251,70,25,6,56,83,375
2016,Joffrey Lauvergne\lauvejo01,PF,25,OKC,50,0,739,111,244,0.455,27,78,0.346,84,166,0.506,0.51,37,58,0.638,51,132,183,51,18,6,40,71,286
2016,Joffrey Lauvergne\lauvejo01,C,25,CHI,20,1,241,37,92,0.402,6,20,0.3,31,72,0.431,0.435,9,15,0.6,21,47,68,19,7,0,16,12,89
2016,Zach LaVine\lavinza01,SG,21,MIN,47,47,1749,326,710,0.459,120,310,0.387,206,400,0.515,0.544,117,140,0.836,19,141,160,139,41,10,85,104,889
2016,Ty Lawson\lawsoty01,PG,29,SAC,69,24,1732,237,522,0.454,34,118,0.288,203,404,0.502,0.487,173,217,0.797,44,135,179,334,74,6,129,119,681
2016,Jake Layman\laymaja01,SF,22,POR,35,1,249,26,89,0.292,13,51,0.255,13,38,0.342,0.365,13,17,0.765,6,18,24,11,9,3,11,22,78
2016,Courtney Lee\leeco01,SG,31,NYK,77,74,2459,321,704,0.456,108,269,0.401,213,435,0.49,0.533,85,98,0.867,53,206,259,179,81,24,69,141,835
2016,David Lee\leeda02,PF,33,SAS,79,10,1477,248,420,0.59,0,0,,248,420,0.59,0.59,80,113,0.708,149,292,441,124,31,40,82,125,576
2016,Alex Len\lenal01,C,23,PHO,77,34,1560,230,463,0.497,3,12,0.25,227,451,0.503,0.5,150,208,0.721,156,354,510,44,38,98,102,242,613
2016,Kawhi Leonard\leonaka01,SF,25,SAS,74,74,2474,636,1312,0.485,147,387,0.38,489,925,0.529,0.541,469,533,0.88,80,350,430,260,133,55,154,122,1888
2016,Meyers Leonard\leoname01,PF,24,POR,74,12,1222,146,378,0.386,74,213,0.347,72,165,0.436,0.484,35,40,0.875,27,210,237,71,13,28,35,172,401
2016,Jon Leuer\leuerjo01,PF,27,DET,75,34,1944,310,646,0.48,49,167,0.293,261,479,0.545,0.518,98,113,0.867,102,300,402,111,31,26,66,145,767
2016,Caris LeVert\leverca01,SF,22,BRK,57,26,1237,171,380,0.45,59,184,0.321,112,196,0.571,0.528,67,93,0.72,23,165,188,110,49,8,59,91,468
2016,DeAndre Liggins\liggide01,SG,28,TOT,62,19,777,55,142,0.387,17,46,0.37,38,96,0.396,0.447,25,40,0.625,20,88,108,54,47,14,42,81,152
2016,DeAndre Liggins\liggide01,SG,28,CLE,61,19,752,52,136,0.382,17,45,0.378,35,91,0.385,0.445,23,37,0.622,17,84,101,54,45,14,42,78,144
2016,DeAndre Liggins\liggide01,SG,28,DAL,1,0,25,3,6,0.5,0,1,0,3,5,0.6,0.5,2,3,0.667,3,4,7,0,2,0,0,3,8
2016,Damian Lillard\lillada01,PG,26,POR,75,75,2694,661,1488,0.444,214,579,0.37,447,909,0.492,0.516,488,545,0.895,46,322,368,440,68,20,197,152,2024
2016,Jeremy Lin\linje01,PG,28,BRK,36,33,883,175,400,0.438,58,156,0.372,117,244,0.48,0.51,115,141,0.816,11,124,135,184,42,14,86,79,523
2016,Shaun Livingston\livinsh01,PG,31,GSW,76,3,1345,173,316,0.547,1,3,0.333,172,313,0.55,0.549,42,60,0.7,28,123,151,139,38,20,62,120,389
2016,Shawn Long\longsh01,C,24,PHI,18,0,234,61,109,0.56,7,19,0.368,54,90,0.6,0.592,19,35,0.543,41,44,85,13,9,9,13,49,148
2016,Kevon Looney\looneke01,C,20,GSW,53,4,447,56,107,0.523,2,9,0.222,54,98,0.551,0.533,21,34,0.618,44,80,124,29,15,17,17,64,135
2016,Brook Lopez\lopezbr01,C,28,BRK,75,75,2222,555,1172,0.474,134,387,0.346,421,785,0.536,0.531,295,364,0.81,121,282,403,176,38,124,184,192,1539
2016,Robin Lopez\lopezro01,C,28,CHI,81,81,2271,382,775,0.493,0,2,0,382,773,0.494,0.493,75,104,0.721,244,276,520,80,18,117,91,151,839
2016,Kevin Love\loveke01,PF,28,CLE,60,60,1885,370,867,0.427,145,389,0.373,225,478,0.471,0.51,257,295,0.871,148,518,666,116,53,21,122,125,1142
2016,Kyle Lowry\lowryky01,PG,30,TOR,60,60,2244,426,918,0.464,193,468,0.412,233,450,0.518,0.569,299,365,0.819,48,238,286,417,88,19,173,170,1344
2016,John Lucas III\lucasjo02,PG,34,MIN,5,0,11,1,4,0.25,0,1,0,1,3,0.333,0.25,0,0,,0,0,0,1,2,0,0,0,2
2016,Timothé Luwawu-Cabarrot\luwawti01,SF,21,PHI,69,19,1190,145,361,0.402,50,161,0.311,95,200,0.475,0.471,105,123,0.854,25,124,149,75,32,10,73,154,445
2016,Trey Lyles\lylestr01,PF,21,UTA,71,4,1158,159,439,0.362,65,204,0.319,94,235,0.4,0.436,57,79,0.722,48,187,235,69,26,20,64,97,440
2016,Sheldon Mac\mcclesh01,SG,24,WAS,30,3,287,30,75,0.4,7,30,0.233,23,45,0.511,0.447,23,27,0.852,4,30,34,15,8,2,5,17,90
2016,Shelvin Mack\macksh01,PG,26,UTA,55,9,1205,170,381,0.446,37,120,0.308,133,261,0.51,0.495,53,77,0.688,20,105,125,154,42,3,90,100,430
2016,Ian Mahinmi\mahinia01,C,30,WAS,31,0,555,65,111,0.586,0,0,,65,111,0.586,0.586,43,75,0.573,47,103,150,19,33,24,34,90,173
2016,Thon Maker\makerth01,C,19,MIL,57,34,562,83,181,0.459,28,74,0.378,55,107,0.514,0.536,32,49,0.653,40,74,114,23,10,26,17,84,226
2016,Boban Marjanović\marjabo01,C,28,DET,35,0,293,72,132,0.545,0,0,,72,132,0.545,0.545,47,58,0.81,46,84,130,9,6,12,10,25,191
2016,Jarell Martin\martija01,PF,22,MEM,42,3,558,58,151,0.384,9,25,0.36,49,126,0.389,0.414,40,50,0.8,42,120,162,8,17,9,28,91,165
2016,Wesley Matthews\matthwe02,SG,30,DAL,73,73,2495,333,847,0.393,174,479,0.363,159,368,0.432,0.496,146,179,0.816,18,241,259,210,77,15,102,161,986
2016,Luc Mbah a Moute\mbahalu01,SF,30,LAC,80,76,1787,191,378,0.505,43,110,0.391,148,268,0.552,0.562,59,87,0.678,44,126,170,39,81,35,46,122,484
2016,James Michael McAdoo\mcadoja01,PF,24,GSW,52,2,457,62,117,0.53,2,8,0.25,60,109,0.55,0.538,21,42,0.5,34,57,91,18,18,29,19,47,147
2016,Patrick McCaw\mccawpa01,SG,21,GSW,71,20,1074,106,245,0.433,41,123,0.333,65,122,0.533,0.516,29,37,0.784,21,79,100,77,32,15,36,62,282
2016,CJ McCollum\mccolcj01,SG,25,POR,80,80,2796,692,1441,0.48,185,439,0.421,507,1002,0.506,0.544,268,294,0.912,60,229,289,285,72,42,172,202,1837
2016,T.J. McConnell\mccontj01,PG,24,PHI,81,51,2133,236,512,0.461,11,55,0.2,225,457,0.492,0.472,73,90,0.811,39,212,251,534,134,10,159,139,556
2016,Chris McCullough\mcculch01,PF,21,TOT,16,0,80,16,32,0.5,1,7,0.143,15,25,0.6,0.516,3,5,0.6,9,10,19,2,2,2,3,7,36
2016,Chris McCullough\mcculch01,PF,21,BRK,14,0,72,16,31,0.516,1,6,0.167,15,25,0.6,0.532,2,3,0.667,9,8,17,2,1,2,2,7,35
2016,Chris McCullough\mcculch01,PF,21,WAS,2,0,8,0,1,0,0,1,0,0,0,,0,1,2,0.5,0,2,2,0,1,0,1,0,1
2016,K.J. McDaniels\mcdankj01,SF,23,TOT,49,0,505,77,169,0.456,20,66,0.303,57,103,0.553,0.515,32,38,0.842,15,67,82,13,19,18,29,49,206
2016,K.J. McDaniels\mcdankj01,SF,23,HOU,29,0,212,31,68,0.456,9,27,0.333,22,41,0.537,0.522,9,10,0.9,6,24,30,4,7,8,10,24,80
2016,K.J. McDaniels\mcdankj01,SF,23,BRK,20,0,293,46,101,0.455,11,39,0.282,35,62,0.565,0.51,23,28,0.821,9,43,52,9,12,10,19,25,126
2016,Doug McDermott\mcderdo01,SF,25,TOT,66,5,1508,222,497,0.447,77,208,0.37,145,289,0.502,0.524,71,84,0.845,20,159,179,58,13,5,38,79,592
2016,Doug McDermott\mcderdo01,SF,25,CHI,44,4,1078,166,373,0.445,56,150,0.373,110,223,0.493,0.52,59,67,0.881,14,116,130,45,11,4,32,57,447
2016,Doug McDermott\mcderdo01,SF,25,OKC,22,1,430,56,124,0.452,21,58,0.362,35,66,0.53,0.536,12,17,0.706,6,43,49,13,2,1,6,22,145
2016,JaVale McGee\mcgeeja01,C,29,GSW,77,10,739,208,319,0.652,0,3,0,208,316,0.658,0.652,56,111,0.505,100,144,244,17,19,67,40,109,472
2016,Rodney McGruder\mcgruro01,SG,25,MIA,78,65,1966,190,460,0.413,73,220,0.332,117,240,0.488,0.492,44,71,0.62,94,162,256,124,46,18,56,140,497
2016,Ben McLemore\mclembe01,SG,23,SAC,61,26,1176,180,419,0.43,65,170,0.382,115,249,0.462,0.507,70,93,0.753,19,110,129,51,29,6,62,108,495
2016,Jordan McRae\mcraejo01,SG,25,CLE,37,4,384,58,150,0.387,18,51,0.353,40,99,0.404,0.447,27,34,0.794,6,35,41,19,8,6,14,31,161
2016,Josh McRoberts\mcrobjo01,PF,29,MIA,22,14,381,44,118,0.373,13,31,0.419,31,87,0.356,0.428,6,9,0.667,23,51,74,50,10,4,23,31,107
2016,Jodie Meeks\meeksjo01,SG,29,ORL,36,10,738,103,256,0.402,56,137,0.409,47,119,0.395,0.512,65,74,0.878,5,72,77,45,34,4,36,41,327
2016,Salah Mejri\mejrisa01,C,30,DAL,73,11,905,88,137,0.642,1,3,0.333,87,134,0.649,0.646,36,61,0.59,97,211,308,14,32,61,40,152,213
2016,Jordan Mickey\mickejo01,PF,22,BOS,25,1,141,15,34,0.441,0,1,0,15,33,0.455,0.441,8,14,0.571,13,21,34,7,3,6,9,12,38
2016,Khris Middleton\middlkh01,SF,25,MIL,29,23,889,150,333,0.45,45,104,0.433,105,229,0.459,0.518,81,92,0.88,11,112,123,99,41,7,65,79,426
2016,C.J. Miles\milescj01,SF,29,IND,76,29,1776,281,647,0.434,169,409,0.413,112,238,0.471,0.565,84,93,0.903,30,199,229,48,46,25,40,151,815
2016,Mike Miller\millemi01,SF,36,DEN,20,0,151,9,23,0.391,8,20,0.4,1,3,0.333,0.565,2,2,1,2,36,38,22,2,0,13,9,28
2016,Patty Mills\millspa02,PG,28,SAS,80,8,1754,273,621,0.44,147,355,0.414,126,266,0.474,0.558,66,80,0.825,24,117,141,280,65,3,101,109,759
2016,Elijah Millsap\millsel01,SG,29,PHO,2,0,23,1,7,0.143,0,2,0,1,5,0.2,0.143,1,2,0.5,3,3,6,1,0,0,2,2,3
2016,Paul Millsap\millspa01,PF,31,ATL,69,67,2343,430,972,0.442,75,241,0.311,355,731,0.486,0.481,311,405,0.768,111,422,533,252,90,62,158,186,1246
2016,Nikola Mirotić\mirotni01,PF,25,CHI,70,15,1679,258,625,0.413,129,377,0.342,129,248,0.52,0.516,99,128,0.773,61,323,384,75,53,55,80,128,744
2016,Greg Monroe\monrogr01,C,26,MIL,81,0,1823,387,726,0.533,0,4,0,387,722,0.536,0.533,177,239,0.741,167,365,532,187,92,38,140,168,951
2016,E'Twaun Moore\mooreet01,SG,27,NOP,73,22,1820,283,619,0.457,77,208,0.37,206,411,0.501,0.519,57,74,0.77,33,119,152,164,50,32,62,131,700
2016,Marcus Morris\morrima03,SF,27,DET,79,79,2565,421,1007,0.418,118,357,0.331,303,650,0.466,0.477,145,185,0.784,77,289,366,160,52,25,87,168,1105
2016,Markieff Morris\morrima02,PF,27,WAS,76,76,2374,406,889,0.457,71,196,0.362,335,693,0.483,0.497,180,215,0.837,107,386,493,126,82,42,129,254,1063
2016,Anthony Morrow\morroan01,SG,31,TOT,49,7,714,98,252,0.389,41,133,0.308,57,119,0.479,0.47,34,37,0.919,12,19,31,25,24,2,6,44,271
2016,Anthony Morrow\morroan01,SG,31,OKC,40,7,627,86,223,0.386,35,119,0.294,51,104,0.49,0.464,23,26,0.885,11,18,29,19,22,2,6,40,230
2016,Anthony Morrow\morroan01,SG,31,CHI,9,0,87,12,29,0.414,6,14,0.429,6,15,0.4,0.517,11,11,1,1,1,2,6,2,0,0,4,41
2016,Donatas Motiejūnas\motiedo01,PF,26,NOP,34,0,479,57,138,0.413,11,47,0.234,46,91,0.505,0.453,25,49,0.51,26,75,101,32,18,11,31,55,150
2016,Timofey Mozgov\mozgoti01,C,30,LAL,54,52,1104,169,328,0.515,0,1,0,169,327,0.517,0.515,63,78,0.808,104,160,264,43,16,31,72,133,401
2016,Emmanuel Mudiay\mudiaem01,PG,20,DEN,55,41,1406,208,551,0.377,56,178,0.315,152,373,0.408,0.428,131,167,0.784,29,149,178,217,41,13,123,95,603
2016,Shabazz Muhammad\muhamsh01,SF,24,MIN,78,1,1516,288,598,0.482,49,145,0.338,239,453,0.528,0.523,147,190,0.774,84,136,220,35,22,6,56,86,772
2016,Dejounte Murray\murrade01,PG,20,SAS,38,8,322,50,116,0.431,9,23,0.391,41,93,0.441,0.47,21,30,0.7,6,36,42,48,8,6,38,29,130
2016,Jamal Murray\murraja01,SG,19,DEN,82,10,1764,295,730,0.404,115,344,0.334,180,386,0.466,0.483,106,120,0.883,41,173,214,170,51,24,113,124,811
2016,Mike Muscala\muscami01,C,25,ATL,70,3,1237,170,337,0.504,46,110,0.418,124,227,0.546,0.573,49,64,0.766,76,164,240,95,30,41,55,97,435
2016,Larry Nance Jr.\nancela02,PF,24,LAL,63,7,1442,190,361,0.526,10,36,0.278,180,325,0.554,0.54,59,80,0.738,120,249,369,96,82,39,56,149,449
2016,Shabazz Napier\napiesh01,PG,25,POR,53,2,512,73,183,0.399,34,92,0.37,39,91,0.429,0.492,38,49,0.776,8,53,61,67,32,2,41,38,218
2016,Maurice Ndour\ndourma01,PF,24,NYK,32,4,331,39,86,0.453,1,7,0.143,38,79,0.481,0.459,19,26,0.731,22,42,64,8,15,8,12,30,98
2016,Gary Neal\nealga01,SG,32,ATL,2,0,18,0,7,0,0,2,0,0,5,0,0,4,4,1,0,1,1,1,0,0,0,1,4
2016,Jameer Nelson\nelsoja01,PG,34,DEN,75,39,2045,268,604,0.444,106,273,0.388,162,331,0.489,0.531,45,63,0.714,28,164,192,385,54,8,128,197,687
2016,Raul Neto\netora01,PG,24,UTA,40,0,346,41,91,0.451,10,31,0.323,31,60,0.517,0.505,8,9,0.889,4,26,30,34,21,5,15,48,100
2016,Georges Niang\niangge01,PF,23,IND,23,0,93,9,36,0.25,1,12,0.083,8,24,0.333,0.264,2,2,1,2,15,17,5,3,0,5,6,21
2016,Andrew Nicholson\nichoan01,PF,27,TOT,38,0,342,43,111,0.387,5,27,0.185,38,84,0.452,0.41,9,14,0.643,15,46,61,10,16,6,17,55,100
2016,Andrew Nicholson\nichoan01,PF,27,WAS,28,0,231,30,77,0.39,3,16,0.188,27,61,0.443,0.409,7,12,0.583,11,23,34,7,11,6,11,37,70
2016,Andrew Nicholson\nichoan01,PF,27,BRK,10,0,111,13,34,0.382,2,11,0.182,11,23,0.478,0.412,2,2,1,4,23,27,3,5,0,6,18,30
2016,Joakim Noah\noahjo01,C,31,NYK,46,46,1015,99,202,0.49,0,1,0,99,201,0.493,0.49,34,78,0.436,162,241,403,103,30,37,58,127,232
2016,Nerlens Noel\noelne01,C,22,TOT,51,19,1047,184,309,0.595,0,1,0,184,308,0.597,0.595,77,111,0.694,93,201,294,50,65,50,51,126,445
2016,Nerlens Noel\noelne01,C,22,PHI,29,7,564,107,175,0.611,0,1,0,107,174,0.615,0.611,43,63,0.683,46,98,144,30,43,26,29,71,257
2016,Nerlens Noel\noelne01,C,22,DAL,22,12,483,77,134,0.575,0,0,,77,134,0.575,0.575,34,48,0.708,47,103,150,20,22,24,22,55,188
2016,Lucas Nogueira\noguelu01,C,24,TOR,57,6,1088,103,156,0.66,3,12,0.25,100,144,0.694,0.67,44,67,0.657,82,162,244,42,52,89,46,137,253
2016,Steve Novak\novakst01,PF,33,MIL,8,0,22,2,7,0.286,1,6,0.167,1,1,1,0.357,0,0,,0,3,3,0,0,0,0,1,5
2016,Dirk Nowitzki\nowitdi01,PF,38,DAL,54,54,1424,296,678,0.437,79,209,0.378,217,469,0.463,0.495,98,112,0.875,23,330,353,82,30,38,51,113,769
2016,Jusuf Nurkić\nurkiju01,C,22,TOT,65,48,1391,271,534,0.507,0,1,0,271,533,0.508,0.507,120,210,0.571,154,313,467,123,50,74,143,161,662
2016,Jusuf Nurkić\nurkiju01,C,22,DEN,45,29,807,151,298,0.507,0,0,,151,298,0.507,0.507,56,113,0.496,89,171,260,60,25,36,81,88,358
2016,Jusuf Nurkić\nurkiju01,C,22,POR,20,19,584,120,236,0.508,0,1,0,120,235,0.511,0.508,64,97,0.66,65,142,207,63,25,38,62,73,304
2016,David Nwaba\nwabada01,SG,24,LAL,20,2,397,47,81,0.58,1,5,0.2,46,76,0.605,0.586,25,39,0.641,17,46,63,14,13,7,11,36,120
2016,Johnny O'Bryant\obryajo01,PF,23,TOT,11,0,80,15,30,0.5,3,6,0.5,12,24,0.5,0.55,5,6,0.833,9,10,19,6,0,1,6,10,38
2016,Johnny O'Bryant\obryajo01,PF,23,DEN,7,0,46,7,15,0.467,2,3,0.667,5,12,0.417,0.533,4,4,1,5,6,11,2,0,1,3,4,20
2016,Johnny O'Bryant\obryajo01,PF,23,CHO,4,0,34,8,15,0.533,1,3,0.333,7,12,0.583,0.567,1,2,0.5,4,4,8,4,0,0,3,6,18
2016,Kyle O'Quinn\oquinky01,C,26,NYK,79,8,1229,215,413,0.521,2,17,0.118,213,396,0.538,0.523,64,83,0.771,157,282,439,117,36,104,76,174,496
2016,Daniel Ochefu\ochefda01,C,23,WAS,19,0,75,12,27,0.444,0,0,,12,27,0.444,0.444,0,2,0,5,17,22,3,2,0,3,17,24
2016,Jahlil Okafor\okafoja01,C,21,PHI,50,33,1134,242,471,0.514,0,0,,242,471,0.514,0.514,106,158,0.671,81,159,240,58,20,49,91,122,590
2016,Victor Oladipo\oladivi01,SG,24,OKC,67,67,2222,412,932,0.442,127,352,0.361,285,580,0.491,0.51,116,154,0.753,39,252,291,176,78,21,119,155,1067
2016,Kelly Olynyk\olynyke01,C,25,BOS,75,6,1538,260,508,0.512,68,192,0.354,192,316,0.608,0.579,90,123,0.732,73,288,361,148,43,29,96,207,678
2016,Arinze Onuaku\onuakar01,C,29,ORL,8,0,28,2,4,0.5,0,0,,2,4,0.5,0.5,0,0,,2,4,6,2,0,1,2,3,4
2016,Chinanu Onuaku\onuakch01,C,20,HOU,5,1,52,5,7,0.714,0,0,,5,7,0.714,0.714,4,4,1,2,8,10,3,3,1,4,6,14
2016,Kelly Oubre Jr.\oubreke01,SF,21,WAS,79,5,1605,186,442,0.421,54,188,0.287,132,254,0.52,0.482,75,99,0.758,61,200,261,47,58,17,50,195,501
2016,Zaza Pachulia\pachuza01,C,32,GSW,70,70,1268,164,307,0.534,0,2,0,164,305,0.538,0.534,98,126,0.778,140,270,410,132,59,33,87,166,426
2016,Georgios Papagiannis\papagge01,C,19,SAC,22,0,355,56,102,0.549,0,2,0,56,100,0.56,0.549,12,14,0.857,24,62,86,20,3,17,24,44,124
2016,Jabari Parker\parkeja01,PF,21,MIL,51,50,1728,399,814,0.49,65,178,0.365,334,636,0.525,0.53,162,218,0.743,79,235,314,142,50,22,93,111,1025
2016,Tony Parker\parketo01,PG,34,SAS,63,63,1587,265,569,0.466,23,69,0.333,242,500,0.484,0.486,85,117,0.726,9,104,113,285,34,2,89,92,638
2016,Chandler Parsons\parsoch01,SF,28,MEM,34,34,675,75,222,0.338,25,93,0.269,50,129,0.388,0.394,35,43,0.814,6,78,84,55,20,5,24,52,210
2016,Lamar Patterson\pattela01,SG,25,ATL,5,0,40,3,15,0.2,1,6,0.167,2,9,0.222,0.233,2,3,0.667,1,6,7,6,1,0,4,6,9
2016,Patrick Patterson\pattepa01,PF,27,TOR,65,8,1599,154,384,0.401,94,253,0.372,60,131,0.458,0.523,43,60,0.717,62,231,293,76,40,23,38,120,445
2016,Chris Paul\paulch01,PG,31,LAC,61,61,1921,374,785,0.476,124,302,0.411,250,483,0.518,0.555,232,260,0.892,40,264,304,563,119,8,147,146,1104
2016,Adreian Payne\paynead01,PF,25,MIN,18,0,135,23,54,0.426,3,15,0.2,20,39,0.513,0.454,14,19,0.737,9,24,33,7,8,7,8,32,63
2016,Cameron Payne\payneca01,PG,22,TOT,31,0,462,64,193,0.332,27,86,0.314,37,107,0.346,0.402,5,8,0.625,3,45,48,55,14,4,29,52,160
2016,Cameron Payne\payneca01,PG,22,OKC,20,0,320,43,130,0.331,16,52,0.308,27,78,0.346,0.392,4,4,1,2,29,31,40,10,4,16,38,106
2016,Cameron Payne\payneca01,PG,22,CHI,11,0,142,21,63,0.333,11,34,0.324,10,29,0.345,0.421,1,4,0.25,1,16,17,15,4,0,13,14,54
2016,Elfrid Payton\paytoel01,PG,22,ORL,82,58,2412,430,912,0.471,40,146,0.274,390,766,0.509,0.493,146,211,0.692,89,298,387,529,88,40,178,177,1046
2016,Gary Payton II\paytoga02,PG,24,MIL,6,0,99,8,22,0.364,1,9,0.111,7,13,0.538,0.386,3,5,0.6,0,12,12,13,3,4,10,9,20
2016,Paul Pierce\piercpa01,SF,39,LAC,25,7,277,28,70,0.4,15,43,0.349,13,27,0.481,0.507,10,13,0.769,1,47,48,10,4,5,16,40,81
2016,Marshall Plumlee\plumlma02,C,24,NYK,21,1,170,16,30,0.533,0,0,,16,30,0.533,0.533,8,19,0.421,23,28,51,10,4,4,12,23,40
2016,Mason Plumlee\plumlma01,C,26,TOT,81,64,2148,334,623,0.536,0,6,0,334,617,0.541,0.536,174,300,0.58,170,435,605,284,69,92,134,226,842
2016,Mason Plumlee\plumlma01,C,26,POR,54,54,1516,235,442,0.532,0,5,0,235,437,0.538,0.532,127,224,0.567,120,312,432,214,50,63,88,149,597
2016,Mason Plumlee\plumlma01,C,26,DEN,27,10,632,99,181,0.547,0,1,0,99,180,0.55,0.547,47,76,0.618,50,123,173,70,19,29,46,77,245
2016,Miles Plumlee\plumlmi01,C,28,TOT,45,12,484,44,92,0.478,0,0,,44,92,0.478,0.478,25,39,0.641,38,57,95,21,18,13,30,73,113
2016,Miles Plumlee\plumlmi01,C,28,MIL,32,12,310,30,68,0.441,0,0,,30,68,0.441,0.441,22,35,0.629,23,30,53,18,11,9,22,48,82
2016,Miles Plumlee\plumlmi01,C,28,CHO,13,0,174,14,24,0.583,0,0,,14,24,0.583,0.583,3,4,0.75,15,27,42,3,7,4,8,25,31
2016,Jakob Poeltl\poeltja01,C,21,TOR,54,4,626,67,115,0.583,0,0,,67,115,0.583,0.583,31,57,0.544,78,87,165,12,17,20,29,113,165
2016,Otto Porter\porteot01,SF,23,WAS,80,80,2605,414,803,0.516,148,341,0.434,266,462,0.576,0.608,99,119,0.832,118,396,514,121,116,42,44,193,1075
2016,Bobby Portis\portibo01,PF,21,CHI,64,13,1000,183,375,0.488,32,96,0.333,151,279,0.541,0.531,39,59,0.661,75,221,296,35,16,11,37,94,437
2016,Kristaps Porziņģis\porzikr01,PF,21,NYK,66,65,2164,443,985,0.45,112,314,0.357,331,671,0.493,0.507,198,252,0.786,111,364,475,97,47,129,118,244,1196
2016,Dwight Powell\poweldw01,C,25,DAL,77,3,1333,194,377,0.515,21,74,0.284,173,303,0.571,0.542,107,141,0.759,93,213,306,49,61,39,34,135,516
2016,Norman Powell\powelno01,SG,23,TOR,76,18,1368,227,506,0.449,56,173,0.324,171,333,0.514,0.504,126,159,0.792,26,143,169,82,52,14,70,127,636
2016,Alex Poythress\poythal01,PF,23,PHI,6,1,157,25,54,0.463,6,19,0.316,19,35,0.543,0.519,8,10,0.8,11,18,29,5,3,2,3,14,64
2016,Ronnie Price\pricero01,PG,33,PHO,14,0,134,4,24,0.167,3,17,0.176,1,7,0.143,0.229,3,4,0.75,3,8,11,18,11,1,3,14,14
2016,Tim Quarterman\quartti01,SG,22,POR,16,0,80,13,29,0.448,5,13,0.385,8,16,0.5,0.534,0,3,0,4,10,14,11,2,3,11,6,31
2016,Chasson Randle\randlch01,PG,23,TOT,26,0,299,40,98,0.408,16,47,0.34,24,51,0.471,0.49,41,43,0.953,6,26,32,34,9,2,19,39,137
2016,Chasson Randle\randlch01,PG,23,PHI,8,0,74,12,26,0.462,6,15,0.4,6,11,0.545,0.577,12,12,1,0,5,5,6,3,1,3,11,42
2016,Chasson Randle\randlch01,PG,23,NYK,18,0,225,28,72,0.389,10,32,0.313,18,40,0.45,0.458,29,31,0.935,6,21,27,28,6,1,16,28,95
2016,Julius Randle\randlju01,PF,22,LAL,74,73,2132,377,773,0.488,17,63,0.27,360,710,0.507,0.499,204,282,0.723,150,486,636,264,49,37,173,248,975
2016,Zach Randolph\randoza01,PF,35,MEM,73,5,1786,433,964,0.449,21,94,0.223,412,870,0.474,0.46,141,193,0.731,182,416,598,122,38,10,99,136,1028
2016,J.J. Redick\redicjj01,SG,32,LAC,78,78,2198,396,890,0.445,201,468,0.429,195,422,0.462,0.558,180,202,0.891,11,160,171,110,54,13,98,125,1173
2016,Willie Reed\reedwi02,C,26,MIA,71,5,1031,162,285,0.568,1,4,0.25,161,281,0.573,0.57,49,88,0.557,129,203,332,26,18,47,31,137,374
2016,Josh Richardson\richajo01,SG,23,MIA,53,34,1614,202,513,0.394,75,227,0.33,127,286,0.444,0.467,60,77,0.779,35,133,168,140,60,39,65,132,539
2016,Malachi Richardson\richama01,SG,21,SAC,22,0,198,28,68,0.412,8,28,0.286,20,40,0.5,0.471,15,19,0.789,3,20,23,11,5,1,8,23,79
2016,Austin Rivers\riverau01,SG,24,LAC,74,29,2054,323,731,0.442,111,299,0.371,212,432,0.491,0.518,132,191,0.691,20,141,161,204,48,10,115,187,889
2016,Andre Roberson\roberan03,SF,25,OKC,79,79,2376,215,463,0.464,45,184,0.245,170,279,0.609,0.513,47,111,0.423,98,305,403,79,94,79,51,204,522
2016,Brian Roberts\roberbr01,PG,31,CHO,41,2,416,46,122,0.377,17,44,0.386,29,78,0.372,0.447,33,39,0.846,5,34,39,52,9,1,26,18,142
2016,Glenn Robinson III\robingl02,SF,23,IND,69,27,1427,158,338,0.467,49,125,0.392,109,213,0.512,0.54,54,76,0.711,57,189,246,47,41,20,37,63,419
2016,Thomas Robinson\robinth01,PF,25,LAL,48,1,560,105,196,0.536,0,1,0,105,195,0.538,0.536,31,66,0.47,84,139,223,31,26,9,46,76,241
2016,Sergio Rodríguez\rodrise01,PG,30,PHI,68,30,1518,210,536,0.392,92,252,0.365,118,284,0.415,0.478,18,27,0.667,21,136,157,344,49,4,128,95,530
2016,Rajon Rondo\rondora01,PG,30,CHI,69,42,1843,229,561,0.408,50,133,0.376,179,428,0.418,0.453,30,50,0.6,73,282,355,461,99,11,169,144,538
2016,Derrick Rose\rosede01,PG,28,NYK,64,64,2082,460,977,0.471,13,60,0.217,447,917,0.487,0.477,221,253,0.874,66,180,246,283,44,17,147,84,1154
2016,Terrence Ross\rosste01,SF,25,TOT,78,24,1955,326,746,0.437,142,391,0.363,184,355,0.518,0.532,64,77,0.831,18,188,206,88,87,33,68,143,858
2016,Terrence Ross\rosste01,SF,25,TOR,54,0,1207,211,479,0.441,96,256,0.375,115,223,0.516,0.541,41,50,0.82,14,124,138,45,53,20,33,82,559
2016,Terrence Ross\rosste01,SF,25,ORL,24,24,748,115,267,0.431,46,135,0.341,69,132,0.523,0.517,23,27,0.852,4,64,68,43,34,13,35,61,299
2016,Terry Rozier\roziete01,PG,22,BOS,74,0,1263,151,411,0.367,57,179,0.318,94,232,0.405,0.437,51,66,0.773,40,187,227,131,46,11,47,69,410
2016,Ricky Rubio\rubiori01,PG,26,MIN,75,75,2469,261,650,0.402,60,196,0.306,201,454,0.443,0.448,254,285,0.891,68,237,305,682,128,10,195,202,836
2016,Damjan Rudež\rudezda01,SF,30,ORL,45,0,314,31,88,0.352,20,64,0.313,11,24,0.458,0.466,0,0,,5,20,25,20,12,1,9,31,82
2016,Brandon Rush\rushbr01,SG,31,MIN,47,33,1030,70,187,0.374,44,114,0.386,26,73,0.356,0.492,13,18,0.722,16,83,99,45,22,23,28,42,197
2016,D'Angelo Russell\russeda01,PG,20,LAL,63,60,1811,351,867,0.405,135,384,0.352,216,483,0.447,0.483,147,188,0.782,31,190,221,303,87,16,176,130,984
2016,Domantas Sabonis\sabondo01,PF,20,OKC,81,66,1632,192,481,0.399,51,159,0.321,141,322,0.438,0.452,44,67,0.657,46,242,288,82,39,32,83,200,479
2016,Larry Sanders\sandela01,C,28,CLE,5,0,13,1,4,0.25,0,0,,1,4,0.25,0.25,2,2,1,3,1,4,0,1,1,2,5,4
2016,Dario Šarić\saricda01,PF,22,PHI,81,36,2129,381,927,0.411,106,341,0.311,275,586,0.469,0.468,172,220,0.782,112,401,513,182,57,30,183,162,1040
2016,Tomáš Satoranský\satorto01,SG,25,WAS,57,3,719,61,147,0.415,9,37,0.243,52,110,0.473,0.446,23,33,0.697,25,58,83,92,26,6,38,60,154
2016,Dennis Schröder\schrode01,PG,23,ATL,79,78,2485,548,1214,0.451,100,294,0.34,448,920,0.487,0.493,218,255,0.855,42,206,248,499,74,16,258,149,1414
2016,Luis Scola\scolalu01,PF,36,BRK,36,1,461,71,151,0.47,17,50,0.34,54,101,0.535,0.526,25,37,0.676,51,88,139,37,14,4,34,63,184
2016,Mike Scott\scottmi01,PF,28,ATL,18,0,195,17,59,0.288,4,27,0.148,13,32,0.406,0.322,7,8,0.875,10,27,37,17,4,3,8,12,45
2016,Thabo Sefolosha\sefolth01,SF,32,ATL,62,42,1596,174,395,0.441,41,120,0.342,133,275,0.484,0.492,55,75,0.733,54,216,270,107,96,31,58,97,444
2016,Wayne Selden\seldewa01,SG,22,TOT,14,5,236,25,58,0.431,7,28,0.25,18,30,0.6,0.491,14,22,0.636,1,15,16,13,6,1,12,18,71
2016,Wayne Selden\seldewa01,SG,22,NOP,3,3,47,5,8,0.625,4,7,0.571,1,1,1,0.875,2,4,0.5,0,5,5,1,2,0,3,6,16
2016,Wayne Selden\seldewa01,SG,22,MEM,11,2,189,20,50,0.4,3,21,0.143,17,29,0.586,0.43,12,18,0.667,1,10,11,12,4,1,9,12,55
2016,Kevin Séraphin\serapke01,PF,27,IND,49,3,559,109,198,0.551,0,2,0,109,196,0.556,0.551,14,22,0.636,41,101,142,23,7,20,29,66,232
2016,Ramon Sessions\sessira01,PG,30,CHO,50,1,811,100,263,0.38,21,62,0.339,79,201,0.393,0.42,91,118,0.771,11,62,73,129,27,3,46,43,312
2016,Iman Shumpert\shumpim01,SG,26,CLE,76,31,1937,201,489,0.411,94,261,0.36,107,228,0.469,0.507,71,90,0.789,39,179,218,109,62,27,78,150,567
2016,Pascal Siakam\siakapa01,PF,22,TOR,55,38,859,103,205,0.502,1,7,0.143,102,198,0.515,0.505,22,32,0.688,64,121,185,17,26,45,33,109,229
2016,Jonathon Simmons\simmojo02,SG,27,SAS,78,8,1392,177,421,0.42,30,102,0.294,147,319,0.461,0.456,99,132,0.75,20,140,160,126,47,25,76,146,483
2016,Kyle Singler\singlky01,SF,28,OKC,32,2,385,34,83,0.41,7,37,0.189,27,46,0.587,0.452,13,17,0.765,8,40,48,9,7,5,11,29,88
2016,Marcus Smart\smartma01,SG,22,BOS,79,24,2399,269,749,0.359,94,332,0.283,175,417,0.42,0.422,203,250,0.812,78,227,305,364,125,34,159,192,835
2016,Ish Smith\smithis01,PG,28,DET,81,32,1955,329,749,0.439,28,105,0.267,301,644,0.467,0.458,72,102,0.706,21,214,235,418,61,33,112,127,758
2016,J.R. Smith\smithjr01,SG,31,CLE,41,35,1187,123,356,0.346,95,271,0.351,28,85,0.329,0.479,10,15,0.667,17,96,113,62,40,11,26,77,351
2016,Jason Smith\smithja02,C,30,WAS,74,3,1068,174,329,0.529,37,78,0.474,137,251,0.546,0.585,35,51,0.686,64,194,258,37,21,54,58,168,420
2016,Tony Snell\snellto01,SG,25,MIL,80,80,2336,246,541,0.455,144,355,0.406,102,186,0.548,0.588,47,58,0.81,22,226,248,96,55,14,55,125,683
2016,Marreese Speights\speigma01,C,29,LAC,82,2,1286,244,548,0.445,103,277,0.372,141,271,0.52,0.539,120,137,0.876,88,285,373,65,23,41,69,229,711
2016,Tiago Splitter\splitti01,C,32,PHI,8,0,76,14,31,0.452,2,6,0.333,12,25,0.48,0.484,9,11,0.818,8,14,22,4,1,1,6,8,39
2016,Nik Stauskas\stausni01,SG,23,PHI,80,27,2188,251,634,0.396,132,359,0.368,119,275,0.433,0.5,122,150,0.813,21,205,226,188,45,32,128,144,756
2016,Lance Stephenson\stephla01,SG,26,TOT,18,0,361,54,120,0.45,6,20,0.3,48,100,0.48,0.475,8,13,0.615,4,48,52,59,5,3,26,32,122
2016,Lance Stephenson\stephla01,SG,26,NOP,6,0,162,26,55,0.473,1,10,0.1,25,45,0.556,0.482,5,8,0.625,3,15,18,29,2,1,11,18,58
2016,Lance Stephenson\stephla01,SG,26,MIN,6,0,67,10,21,0.476,0,2,0,10,19,0.526,0.476,1,2,0.5,0,10,10,5,0,0,4,2,21
2016,Lance Stephenson\stephla01,SG,26,IND,6,0,132,18,44,0.409,5,8,0.625,13,36,0.361,0.466,2,3,0.667,1,23,24,25,3,2,11,12,43
2016,Jarnell Stokes\stokeja01,C,23,DEN,2,0,7,1,1,1,0,0,,1,1,1,1,1,2,0.5,1,1,2,2,1,0,0,3,3
2016,Diamond Stone\stonedi01,C,19,LAC,7,0,24,3,13,0.231,0,0,,3,13,0.231,0.231,4,4,1,1,5,6,0,0,1,2,5,10
2016,Rodney Stuckey\stuckro01,PG,30,IND,39,0,696,91,244,0.373,19,60,0.317,72,184,0.391,0.412,80,107,0.748,6,78,84,84,16,0,53,44,281
2016,Jared Sullinger\sullija01,PF,24,TOR,11,1,118,15,47,0.319,3,18,0.167,12,29,0.414,0.351,4,8,0.5,10,17,27,3,4,1,4,17,37
2016,Edy Tavares\tavarwa01,C,24,TOT,2,0,28,4,5,0.8,0,0,,4,5,0.8,0.8,0,3,0,4,7,11,1,0,6,2,3,8
2016,Edy Tavares\tavarwa01,C,24,ATL,1,0,4,1,1,1,0,0,,1,1,1,1,0,2,0,0,1,1,0,0,0,0,0,2
2016,Edy Tavares\tavarwa01,C,24,CLE,1,0,24,3,4,0.75,0,0,,3,4,0.75,0.75,0,1,0,4,6,10,1,0,6,2,3,6
2016,Isaiah Taylor\taylois01,PG,22,HOU,4,0,52,1,7,0.143,0,2,0,1,5,0.2,0.143,1,2,0.5,1,2,3,3,1,1,0,6,3
2016,Jeff Teague\teaguje01,PG,28,IND,82,82,2657,402,909,0.442,90,252,0.357,312,657,0.475,0.492,360,415,0.867,33,297,330,639,100,32,216,165,1254
2016,Mirza Teletović\teletmi01,PF,31,MIL,70,2,1133,156,418,0.373,104,305,0.341,52,113,0.46,0.498,35,45,0.778,11,151,162,48,12,13,37,109,451
2016,Garrett Temple\templga01,SG,30,SAC,65,21,1728,183,432,0.424,82,220,0.373,101,212,0.476,0.519,58,74,0.784,32,152,184,168,84,28,78,141,506
2016,Jason Terry\terryja01,SG,39,MIL,74,0,1365,105,243,0.432,73,171,0.427,32,72,0.444,0.582,24,29,0.828,15,91,106,98,46,20,36,95,307
2016,Isaiah Thomas\thomais02,PG,27,BOS,76,76,2569,682,1473,0.463,245,646,0.379,437,827,0.528,0.546,590,649,0.909,43,162,205,448,70,13,210,167,2199
2016,Lance Thomas\thomala01,PF,28,NYK,46,15,968,97,244,0.398,38,85,0.447,59,159,0.371,0.475,43,51,0.843,32,110,142,35,21,5,25,85,275
2016,Hollis Thompson\thompho01,SG,25,TOT,40,9,752,77,200,0.385,32,95,0.337,45,105,0.429,0.465,19,29,0.655,19,93,112,35,20,6,11,69,205
2016,Hollis Thompson\thompho01,SG,25,PHI,31,1,561,66,159,0.415,26,71,0.366,40,88,0.455,0.497,13,20,0.65,15,69,84,26,14,6,9,55,171
2016,Hollis Thompson\thompho01,SG,25,NOP,9,8,191,11,41,0.268,6,24,0.25,5,17,0.294,0.341,6,9,0.667,4,24,28,9,6,0,2,14,34
2016,Klay Thompson\thompkl01,SG,26,GSW,78,78,2649,644,1376,0.468,268,647,0.414,376,729,0.516,0.565,186,218,0.853,49,236,285,160,66,40,128,139,1742
2016,Tristan Thompson\thomptr01,C,25,CLE,78,78,2336,262,437,0.6,0,3,0,262,434,0.604,0.6,106,213,0.498,286,429,715,77,39,84,64,176,630
2016,Marcus Thornton\thornma01,SG,29,WAS,33,1,575,84,210,0.4,28,80,0.35,56,130,0.431,0.467,23,27,0.852,22,54,76,41,19,3,25,48,219
2016,Mike Tobey\tobeymi01,C,22,CHO,2,0,25,1,4,0.25,0,0,,1,4,0.25,0.25,0,0,,2,1,3,1,0,0,1,2,2
2016,Anthony Tolliver\tollian01,PF,31,SAC,65,9,1477,155,351,0.442,90,230,0.391,65,121,0.537,0.57,61,82,0.744,51,186,237,77,34,20,56,109,461
2016,Axel Toupane\toupaax01,SF,24,TOT,4,0,47,5,9,0.556,1,4,0.25,4,5,0.8,0.611,0,0,,0,1,1,0,1,1,0,6,11
2016,Axel Toupane\toupaax01,SF,24,MIL,2,0,6,0,1,0,0,1,0,0,0,,0,0,0,,0,0,0,0,0,0,0,1,0
2016,Axel Toupane\toupaax01,SF,24,NOP,2,0,41,5,8,0.625,1,3,0.333,4,5,0.8,0.688,0,0,,0,1,1,0,1,1,0,5,11
2016,Karl-Anthony Towns\townska01,C,21,MIN,82,82,3030,802,1480,0.542,101,275,0.367,701,1205,0.582,0.576,356,428,0.832,296,711,1007,220,56,103,212,241,2061
2016,P.J. Tucker\tuckepj01,SF,31,TOT,81,21,2236,199,482,0.413,70,196,0.357,129,286,0.451,0.485,72,93,0.774,117,354,471,99,116,19,66,196,540
2016,P.J. Tucker\tuckepj01,SF,31,PHO,57,17,1627,147,354,0.415,46,136,0.338,101,218,0.463,0.48,61,77,0.792,94,248,342,73,85,14,52,143,401
2016,P.J. Tucker\tuckepj01,SF,31,TOR,24,4,609,52,128,0.406,24,60,0.4,28,68,0.412,0.5,11,16,0.688,23,106,129,26,31,5,14,53,139
2016,Evan Turner\turneev01,SF,28,POR,65,12,1658,235,552,0.426,31,118,0.263,204,434,0.47,0.454,85,103,0.825,36,211,247,205,53,24,100,121,586
2016,Myles Turner\turnemy01,C,20,IND,81,81,2541,444,869,0.511,40,115,0.348,404,754,0.536,0.534,245,303,0.809,139,450,589,106,74,172,105,262,1173
2016,Beno Udrih\udrihbe01,PG,34,DET,39,0,560,92,197,0.467,11,32,0.344,81,165,0.491,0.495,32,34,0.941,6,51,57,131,13,0,36,29,227
2016,Tyler Ulis\ulisty01,PG,21,PHO,61,15,1123,184,437,0.421,21,79,0.266,163,358,0.455,0.445,55,71,0.775,20,75,95,226,48,5,77,73,444
2016,Jarrod Uthoff\uthofja01,PF,23,DAL,9,0,115,16,38,0.421,3,9,0.333,13,29,0.448,0.461,5,7,0.714,8,14,22,9,2,4,3,8,40
2016,Jonas Valančiūnas\valanjo01,C,24,TOR,80,80,2066,391,702,0.557,1,2,0.5,390,700,0.557,0.558,176,217,0.811,226,533,759,57,37,63,106,216,959
2016,Denzel Valentine\valende01,SG,23,CHI,57,0,976,102,288,0.354,73,208,0.351,29,80,0.363,0.481,14,18,0.778,11,140,151,63,30,7,49,86,291
2016,Fred VanVleet\vanvlfr01,PG,22,TOR,37,0,294,39,111,0.351,11,29,0.379,28,82,0.341,0.401,18,22,0.818,4,38,42,35,16,3,15,36,107
2016,Anderson Varejão\varejan01,C,34,GSW,14,1,92,5,14,0.357,0,0,,5,14,0.357,0.357,8,11,0.727,12,15,27,10,3,3,8,16,18
2016,Greivis Vásquez\vasqugr01,PG,30,BRK,3,0,39,2,8,0.25,1,3,0.333,1,5,0.2,0.313,2,3,0.667,0,2,2,5,1,1,1,6,7
2016,Rashad Vaughn\vaughra01,SG,20,MIL,41,2,458,57,156,0.365,26,81,0.321,31,75,0.413,0.449,2,5,0.4,4,45,49,23,19,10,14,32,142
2016,Noah Vonleh\vonleno01,PF,21,POR,74,41,1265,130,270,0.481,7,20,0.35,123,250,0.492,0.494,60,94,0.638,131,256,387,31,30,27,64,154,327
2016,Nikola Vučević\vucevni01,C,26,ORL,75,55,2163,483,1031,0.468,23,75,0.307,460,956,0.481,0.48,107,160,0.669,176,603,779,208,76,74,117,180,1096
2016,Sasha Vujačić\vujacsa01,SG,32,NYK,42,4,408,42,136,0.309,23,74,0.311,19,62,0.306,0.393,17,24,0.708,12,47,59,52,13,2,16,38,124
2016,Dwyane Wade\wadedw01,SG,35,CHI,60,59,1792,414,955,0.434,45,145,0.31,369,810,0.456,0.457,223,281,0.794,63,207,270,228,86,41,138,112,1096
2016,Dion Waiters\waitedi01,SG,25,MIA,46,43,1384,281,663,0.424,85,215,0.395,196,448,0.438,0.488,82,127,0.646,18,135,153,200,42,20,103,95,729
2016,Kemba Walker\walkeke02,PG,26,CHO,79,79,2739,643,1449,0.444,240,602,0.399,403,847,0.476,0.527,304,359,0.847,45,263,308,434,85,22,168,119,1830
2016,John Wall\walljo01,PG,26,WAS,78,78,2836,647,1435,0.451,89,272,0.327,558,1163,0.48,0.482,422,527,0.801,59,267,326,831,157,49,322,151,1805
2016,Taurean Prince\princta02,SF,22,ATL,59,10,981,114,285,0.4,33,102,0.324,81,183,0.443,0.458,74,94,0.787,25,132,157,55,43,27,61,96,335
2016,T.J. Warren\warretj01,SF,23,PHO,66,59,2048,403,814,0.495,26,98,0.265,377,716,0.527,0.511,119,154,0.773,125,214,339,75,76,39,57,175,951
2016,C.J. Watson\watsocj01,PG,32,ORL,62,9,1012,96,248,0.387,32,105,0.305,64,143,0.448,0.452,57,66,0.864,16,73,89,114,43,2,47,84,281
2016,Briante Weber\weberbr01,PG,24,TOT,20,0,205,25,60,0.417,1,10,0.1,24,50,0.48,0.425,11,16,0.688,8,18,26,21,12,1,8,16,62
2016,Briante Weber\weberbr01,PG,24,GSW,7,0,46,5,14,0.357,0,3,0,5,11,0.455,0.357,2,3,0.667,0,4,4,5,3,1,3,4,12
2016,Briante Weber\weberbr01,PG,24,CHO,13,0,159,20,46,0.435,1,7,0.143,19,39,0.487,0.446,9,13,0.692,8,14,22,16,9,0,5,12,50
2016,David West\westda01,C,36,GSW,68,0,854,135,252,0.536,3,8,0.375,132,244,0.541,0.542,43,56,0.768,47,156,203,151,42,48,78,105,316
2016,Russell Westbrook\westbru01,PG,28,OKC,81,81,2802,824,1941,0.425,200,583,0.343,624,1358,0.459,0.476,710,840,0.845,137,727,864,840,132,31,438,190,2558
2016,Okaro White\whiteok01,PF,24,MIA,35,0,471,33,87,0.379,12,34,0.353,21,53,0.396,0.448,20,22,0.909,25,57,82,21,10,10,18,52,98
2016,Isaiah Whitehead\whiteis01,PG,21,BRK,73,26,1643,204,508,0.402,44,149,0.295,160,359,0.446,0.445,91,113,0.805,32,152,184,192,42,36,142,175,543
2016,Hassan Whiteside\whiteha01,C,27,MIA,77,77,2513,542,973,0.557,0,0,,542,973,0.557,0.557,225,358,0.628,293,795,1088,57,57,161,154,226,1309
2016,Andrew Wiggins\wiggian01,SF,21,MIN,82,82,3048,709,1570,0.452,103,289,0.356,606,1281,0.473,0.484,412,542,0.76,102,226,328,189,82,30,187,183,1933
2016,C.J. Wilcox\wilcocj01,SG,26,ORL,22,0,108,8,31,0.258,3,15,0.2,5,16,0.313,0.306,2,2,1,4,8,12,12,2,1,6,8,21
2016,Alan Williams\willial03,C,24,PHO,47,0,708,138,267,0.517,0,1,0,138,266,0.519,0.517,70,112,0.625,94,198,292,23,27,32,37,125,346
2016,Deron Williams\willide01,PG,32,TOT,64,44,1657,263,600,0.438,85,234,0.363,178,366,0.486,0.509,90,109,0.826,14,133,147,360,31,8,138,138,701
2016,Deron Williams\willide01,PG,32,DAL,40,40,1171,195,453,0.43,63,181,0.348,132,272,0.485,0.5,69,84,0.821,13,89,102,274,25,2,98,96,522
2016,Deron Williams\willide01,PG,32,CLE,24,4,486,68,147,0.463,22,53,0.415,46,94,0.489,0.537,21,25,0.84,1,44,45,86,6,6,40,42,179
2016,Derrick Williams\willide02,PF,25,TOT,50,11,804,108,244,0.443,30,97,0.309,78,147,0.531,0.504,58,89,0.652,19,111,130,28,14,7,28,60,304
2016,Derrick Williams\willide02,PF,25,MIA,25,11,377,54,137,0.394,9,45,0.2,45,92,0.489,0.427,31,50,0.62,16,57,73,14,9,5,14,33,148
2016,Derrick Williams\willide02,PF,25,CLE,25,0,427,54,107,0.505,21,52,0.404,33,55,0.6,0.603,27,39,0.692,3,54,57,14,5,2,14,27,156
2016,Lou Williams\willilo02,SG,30,TOT,81,1,1994,428,998,0.429,163,446,0.365,265,552,0.48,0.511,402,457,0.88,26,176,202,239,80,20,160,92,1421
2016,Lou Williams\willilo02,SG,30,LAL,58,1,1403,326,734,0.444,122,317,0.385,204,417,0.489,0.527,304,344,0.884,14,118,132,183,65,11,120,67,1078
2016,Lou Williams\willilo02,SG,30,HOU,23,0,591,102,264,0.386,41,129,0.318,61,135,0.452,0.464,98,113,0.867,12,58,70,56,15,9,40,25,343
2016,Marvin Williams\willima02,PF,30,CHO,76,76,2295,297,704,0.422,124,354,0.35,173,350,0.494,0.51,131,150,0.873,89,411,500,106,58,53,60,134,849
2016,Reggie Williams\willire02,SF,30,NOP,6,0,79,8,23,0.348,5,11,0.455,3,12,0.25,0.457,6,7,0.857,2,4,6,4,3,0,0,2,27
2016,Troy Williams\willitr02,SF,22,TOT,30,16,557,73,167,0.437,18,62,0.29,55,105,0.524,0.491,21,32,0.656,15,54,69,25,27,10,32,60,185
2016,Troy Williams\willitr02,SF,22,MEM,24,13,418,51,123,0.415,10,41,0.244,41,82,0.5,0.455,15,25,0.6,6,39,45,19,24,9,26,42,127
2016,Troy Williams\willitr02,SF,22,HOU,6,3,139,22,44,0.5,8,21,0.381,14,23,0.609,0.591,6,7,0.857,9,15,24,6,3,1,6,18,58
2016,Kyle Wiltjer\wiltjky01,PF,24,HOU,14,0,44,4,14,0.286,4,13,0.308,0,1,0,0.429,1,2,0.5,4,6,10,2,3,1,5,4,13
2016,Justise Winslow\winslju01,SF,20,MIA,18,15,625,80,225,0.356,7,35,0.2,73,190,0.384,0.371,29,47,0.617,23,71,94,66,26,6,33,52,196
2016,Jeff Withey\witheje01,C,26,UTA,51,1,432,55,103,0.534,0,1,0,55,102,0.539,0.534,36,48,0.75,52,69,121,7,16,32,14,52,146
2016,Christian Wood\woodch01,PF,21,CHO,13,0,107,12,23,0.522,0,5,0,12,18,0.667,0.522,11,15,0.733,14,15,29,2,3,6,7,11,35
2016,Metta World Peace\artesro01,SF,37,LAL,25,2,160,19,68,0.279,9,38,0.237,10,30,0.333,0.346,10,16,0.625,5,15,20,11,10,2,7,18,57
2016,Brandan Wright\wrighbr03,PF,29,MEM,28,5,447,83,135,0.615,0,1,0,83,134,0.619,0.615,23,35,0.657,31,47,78,15,11,20,10,42,189
2016,Delon Wright\wrighde01,PG,24,TOR,27,0,446,49,116,0.422,10,30,0.333,39,86,0.453,0.466,42,55,0.764,16,32,48,57,27,11,25,31,150
2016,James Young\youngja01,SG,21,BOS,29,0,220,25,58,0.431,12,35,0.343,13,23,0.565,0.534,6,9,0.667,6,20,26,4,10,2,4,15,68
2016,Joe Young\youngjo01,PG,24,IND,33,0,135,26,72,0.361,5,23,0.217,21,49,0.429,0.396,11,15,0.733,1,16,17,15,4,0,5,5,68
2016,Nick Young\youngni01,SG,31,LAL,60,60,1556,272,633,0.43,170,421,0.404,102,212,0.481,0.564,77,90,0.856,25,113,138,58,37,14,36,137,791
2016,Thaddeus Young\youngth01,PF,28,IND,74,74,2237,362,687,0.527,45,118,0.381,317,569,0.557,0.56,45,86,0.523,131,317,448,122,113,29,95,135,814
2016,Cody Zeller\zelleco01,C,24,CHO,62,58,1725,253,443,0.571,0,1,0,253,442,0.572,0.571,133,196,0.679,135,270,405,99,62,58,65,189,639
2016,Tyler Zeller\zellety01,C,27,BOS,51,5,525,78,158,0.494,0,1,0,78,157,0.497,0.494,22,39,0.564,43,81,124,42,7,21,20,61,178
2016,Stephen Zimmerman\zimmest01,C,20,ORL,19,0,108,10,31,0.323,0,0,,10,31,0.323,0.323,3,5,0.6,11,24,35,4,2,5,3,17,23
2016,Paul Zipser\zipsepa01,SF,22,CHI,44,18,843,88,221,0.398,33,99,0.333,55,122,0.451,0.473,31,40,0.775,15,110,125,36,15,16,40,78,240
2016,Ivica Zubac\zubaciv01,C,19,LAL,38,11,609,126,238,0.529,0,3,0,126,235,0.536,0.529,32,49,0.653,41,118,159,30,14,33,30,66,284
2015,Quincy Acy\acyqu01,PF,25,SAC,59,29,876,119,214,0.556,19,49,0.388,100,165,0.606,0.6,50,68,0.735,65,123,188,27,29,24,27,103,307
2015,Jordan Adams\adamsjo01,SG,21,MEM,2,0,15,2,6,0.333,0,1,0,2,5,0.4,0.333,3,5,0.6,0,2,2,3,3,0,2,2,7
2015,Steven Adams\adamsst01,C,22,OKC,80,80,2014,261,426,0.613,0,0,,261,426,0.613,0.613,114,196,0.582,219,314,533,62,42,89,84,223,636
2015,Arron Afflalo\afflaar01,SG,30,NYK,71,57,2371,354,799,0.443,91,238,0.382,263,561,0.469,0.5,110,131,0.84,23,243,266,144,25,10,82,142,909
2015,Alexis Ajinça\ajincal01,C,27,NOP,59,17,861,150,315,0.476,0,1,0,150,314,0.478,0.476,52,62,0.839,75,194,269,31,19,36,54,134,352
2015,Cole Aldrich\aldrico01,C,27,LAC,60,5,800,134,225,0.596,0,0,,134,225,0.596,0.596,60,84,0.714,86,202,288,50,47,68,64,139,328
2015,LaMarcus Aldridge\aldrila01,PF,30,SAS,74,74,2261,536,1045,0.513,0,16,0,536,1029,0.521,0.513,259,302,0.858,176,456,632,110,38,81,99,151,1331
2015,Cliff Alexander\alexacl01,PF,20,POR,8,0,36,5,10,0.5,0,0,,5,10,0.5,0.5,0,0,,2,4,6,0,1,2,1,1,10
2015,Lavoy Allen\allenla01,PF,26,IND,79,28,1599,191,370,0.516,0,0,,191,370,0.516,0.516,46,73,0.63,162,262,424,76,26,42,69,147,428
2015,Tony Allen\allento01,SG,34,MEM,64,57,1620,215,469,0.458,15,42,0.357,200,427,0.468,0.474,90,138,0.652,104,192,296,70,110,18,78,175,535
2015,Al-Farouq Aminu\aminual01,SF,25,POR,82,82,2341,299,719,0.416,126,349,0.361,173,370,0.468,0.503,115,156,0.737,98,401,499,138,72,53,120,171,839
2015,Lou Amundson\amundlo01,PF,33,NYK,29,0,204,19,53,0.358,0,0,,19,53,0.358,0.358,14,27,0.519,23,26,49,12,6,7,15,44,52
2015,Chris Andersen\anderch01,C,37,TOT,27,15,402,38,72,0.528,4,14,0.286,34,58,0.586,0.556,25,36,0.694,36,62,98,12,15,13,9,29,105
2015,Chris Andersen\anderch01,C,37,MIA,7,1,36,4,10,0.4,2,5,0.4,2,5,0.4,0.5,3,4,0.75,3,6,9,3,1,3,2,4,13
2015,Chris Andersen\anderch01,C,37,MEM,20,14,366,34,62,0.548,2,9,0.222,32,53,0.604,0.565,22,32,0.688,33,56,89,9,14,10,7,25,92
2015,Alan Anderson\anderal01,SG,33,WAS,13,0,192,21,59,0.356,12,37,0.324,9,22,0.409,0.458,11,15,0.733,1,26,27,14,4,1,2,25,65
2015,James Anderson\anderja01,SG,26,SAC,51,15,721,67,178,0.376,23,86,0.267,44,92,0.478,0.441,22,29,0.759,13,73,86,41,21,14,42,54,179
2015,Justin Anderson\anderju01,SF,22,DAL,55,9,647,71,175,0.406,22,83,0.265,49,92,0.533,0.469,44,55,0.8,18,114,132,29,19,25,24,45,208
2015,Kyle Anderson\anderky01,SF,22,SAS,78,11,1245,138,295,0.468,12,37,0.324,126,258,0.488,0.488,62,83,0.747,25,219,244,123,60,29,59,97,350
2015,Ryan Anderson\anderry01,PF,27,NOP,66,7,2008,397,929,0.427,131,358,0.366,266,571,0.466,0.498,199,228,0.873,131,265,396,73,38,25,90,109,1124
2015,Giannis Antetokounmpo\antetgi01,PG,21,MIL,80,79,2823,513,1013,0.506,28,109,0.257,485,904,0.537,0.52,296,409,0.724,113,499,612,345,94,113,208,258,1350
2015,Thanasis Antetokounmpo\antetth01,SF,23,NYK,2,0,6,3,4,0.75,0,1,0,3,3,1,0.75,0,0,,0,1,1,0,0,0,0,2,6
2015,Carmelo Anthony\anthoca01,SF,31,NYK,72,72,2530,567,1307,0.434,105,310,0.339,462,997,0.463,0.474,334,403,0.829,98,458,556,299,62,38,176,180,1573
2015,Joel Anthony\anthojo01,C,33,DET,19,0,96,6,10,0.6,0,0,,6,10,0.6,0.6,6,8,0.75,8,13,21,1,2,12,2,15,18
2015,Keith Appling\applike01,PG,23,ORL,5,0,27,2,8,0.25,0,3,0,2,5,0.4,0.25,2,2,1,0,1,1,1,1,0,3,5,6
2015,Trevor Ariza\arizatr01,SF,30,HOU,81,81,2859,357,859,0.416,185,499,0.371,172,360,0.478,0.523,126,161,0.783,67,299,366,188,160,26,113,177,1025
2015,Darrell Arthur\arthuda01,PF,27,DEN,70,16,1516,221,489,0.452,45,117,0.385,176,372,0.473,0.498,40,53,0.755,86,207,293,96,53,48,66,185,527
2015,Ömer Aşık\asikom01,C,29,NOP,68,64,1178,104,195,0.533,0,0,,104,195,0.533,0.533,61,112,0.545,120,294,414,26,21,23,60,124,269
2015,D.J. Augustin\augusdj01,PG,28,TOT,62,0,1178,148,350,0.423,68,168,0.405,80,182,0.44,0.52,103,128,0.805,8,87,95,198,38,4,84,85,467
2015,D.J. Augustin\augusdj01,PG,28,OKC,34,0,519,46,121,0.38,24,61,0.393,22,60,0.367,0.479,26,34,0.765,5,38,43,66,13,2,30,41,142
2015,D.J. Augustin\augusdj01,PG,28,DEN,28,0,659,102,229,0.445,44,107,0.411,58,122,0.475,0.541,77,94,0.819,3,49,52,132,25,2,54,44,325
2015,Jeff Ayres\pendeje02,C,28,LAC,17,0,107,12,23,0.522,0,1,0,12,22,0.545,0.522,6,6,1,4,18,22,5,0,3,6,18,30
2015,Luke Babbitt\babbilu01,SF,26,NOP,47,13,845,122,289,0.422,44,109,0.404,78,180,0.433,0.498,39,50,0.78,25,123,148,53,11,7,23,90,327
2015,Cameron Bairstow\bairsca01,C,25,CHI,18,2,103,13,40,0.325,1,5,0.2,12,35,0.343,0.338,7,8,0.875,4,24,28,6,2,3,4,19,34
2015,Leandro Barbosa\barbole01,SG,33,GSW,68,0,1079,171,370,0.462,39,110,0.355,132,260,0.508,0.515,52,62,0.839,28,89,117,82,44,10,53,107,433
2015,J.J. Barea\bareajo01,PG,31,DAL,74,16,1667,317,711,0.446,100,260,0.385,217,451,0.481,0.516,74,96,0.771,26,126,152,302,26,2,113,110,808
2015,Andrea Bargnani\bargnan01,C,30,BRK,46,0,634,127,279,0.455,3,16,0.188,124,263,0.471,0.461,47,57,0.825,28,69,97,18,4,9,26,61,304
2015,Harrison Barnes\barneha02,SF,23,GSW,66,59,2042,295,633,0.466,82,214,0.383,213,419,0.508,0.531,102,134,0.761,77,248,325,117,41,10,57,136,774
2015,Matt Barnes\barnema02,SF,35,MEM,76,45,2190,264,693,0.381,119,370,0.322,145,323,0.449,0.467,111,138,0.804,84,336,420,163,78,57,121,234,758
2015,Will Barton\bartowi01,SG,25,DEN,82,1,2353,425,983,0.432,112,325,0.345,313,658,0.476,0.489,216,268,0.806,59,417,476,203,71,39,139,147,1178
2015,Brandon Bass\bassbr01,PF,30,LAL,66,0,1342,174,317,0.549,0,2,0,174,315,0.552,0.549,125,148,0.845,104,181,285,74,33,55,42,125,473
2015,Nicolas Batum\batumni01,SF,27,CHO,70,70,2448,372,873,0.426,139,399,0.348,233,474,0.492,0.506,163,192,0.849,55,373,428,403,65,43,205,114,1046
2015,Jerryd Bayless\bayleje01,SG,27,MIL,52,18,1505,185,437,0.423,101,231,0.437,84,206,0.408,0.539,70,90,0.778,21,120,141,163,47,11,73,111,541
2015,Aron Baynes\baynear01,C,29,DET,81,1,1233,194,384,0.505,0,2,0,194,382,0.508,0.505,126,165,0.764,140,244,384,51,21,52,67,151,514
2015,Kent Bazemore\bazemke01,SF,26,ATL,75,68,2083,320,725,0.441,109,305,0.357,211,420,0.502,0.517,123,151,0.815,28,351,379,171,98,38,138,176,872
2015,Bradley Beal\bealbr01,SG,22,WAS,55,35,1708,359,799,0.449,105,271,0.387,254,528,0.481,0.515,135,176,0.767,41,147,188,162,54,11,112,117,958
2015,Michael Beasley\beaslmi01,PF,27,HOU,20,0,363,107,205,0.522,3,9,0.333,104,196,0.531,0.529,38,49,0.776,29,69,98,16,11,9,24,39,255
2015,Marco Belinelli\belinma01,SG,29,SAC,68,7,1672,245,635,0.386,91,297,0.306,154,338,0.456,0.457,115,138,0.833,10,107,117,127,37,2,80,91,696
2015,Anthony Bennett\bennean01,PF,22,TOR,19,0,84,8,27,0.296,3,14,0.214,5,13,0.385,0.352,9,10,0.9,6,17,23,0,5,0,4,8,28
2015,Patrick Beverley\beverpa01,PG,27,HOU,71,63,2041,258,594,0.434,124,310,0.4,134,284,0.472,0.539,60,88,0.682,73,177,250,239,94,26,91,234,700
2015,Bismack Biyombo\biyombi01,C,23,TOR,82,22,1808,156,288,0.542,0,1,0,156,287,0.544,0.542,142,226,0.628,182,473,655,29,19,133,71,225,454
2015,Nemanja Bjelica\bjeline01,PF,27,MIN,60,0,1075,110,235,0.468,48,125,0.384,62,110,0.564,0.57,40,55,0.727,49,161,210,83,26,21,47,154,308
2015,Tarik Black\blackta01,C,24,LAL,39,0,496,57,104,0.548,0,0,,57,104,0.548,0.548,19,45,0.422,44,113,157,16,14,18,22,78,133
2015,DeJuan Blair\blairde01,C,26,WAS,29,0,218,28,68,0.412,0,1,0,28,67,0.418,0.412,5,13,0.385,20,37,57,11,8,2,15,53,61
2015,Steve Blake\blakest01,PG,35,DET,58,2,986,93,240,0.388,52,151,0.344,41,89,0.461,0.496,16,20,0.8,9,80,89,200,24,5,81,70,254
2015,Eric Bledsoe\bledser01,PG,26,PHO,31,31,1059,223,492,0.453,48,129,0.372,175,363,0.482,0.502,138,172,0.802,18,107,125,190,63,19,110,75,632
2015,Bojan Bogdanović\bogdabo02,SF,26,BRK,79,39,2115,324,749,0.433,129,338,0.382,195,411,0.474,0.519,110,132,0.833,36,219,255,99,29,5,115,119,887
2015,Andrew Bogut\bogutan01,C,31,GSW,70,66,1451,175,279,0.627,1,1,1,174,278,0.626,0.629,24,50,0.48,121,371,492,162,33,114,83,221,375
2015,Matt Bonner\bonnema01,C,35,SAS,30,2,206,29,57,0.509,15,34,0.441,14,23,0.609,0.64,3,4,0.75,3,24,27,9,6,1,3,16,76
2015,Devin Booker\bookede01,SG,19,PHO,76,51,2108,367,867,0.423,99,289,0.343,268,578,0.464,0.48,215,256,0.84,27,160,187,200,44,20,160,225,1048
2015,Trevor Booker\booketr01,PF,28,UTA,79,2,1632,190,388,0.49,12,41,0.293,178,347,0.513,0.505,71,106,0.67,166,286,452,84,59,41,81,169,463
2015,Chris Bosh\boshch01,PF,31,MIA,53,53,1778,358,767,0.467,81,222,0.365,277,545,0.508,0.52,213,268,0.795,48,342,390,128,36,34,78,101,1010
2015,Avery Bradley\bradlav01,SG,25,BOS,76,72,2536,456,1019,0.447,147,407,0.361,309,612,0.505,0.52,96,123,0.78,48,172,220,158,117,19,109,164,1155
2015,Elton Brand\brandel01,C,36,PHI,17,1,225,31,72,0.431,0,1,0,31,71,0.437,0.431,8,9,0.889,9,54,63,18,9,8,11,32,70
2015,Corey Brewer\breweco01,SF,29,HOU,82,12,1669,212,552,0.384,61,224,0.272,151,328,0.46,0.439,105,140,0.75,42,157,199,109,84,19,78,168,590
2015,Aaron Brooks\brookaa01,PG,31,CHI,69,0,1108,188,469,0.401,66,185,0.357,122,284,0.43,0.471,49,64,0.766,21,80,101,180,30,10,82,132,491
2015,Anthony Brown\brownan02,SF,23,LAL,29,11,599,39,126,0.31,20,70,0.286,19,56,0.339,0.389,17,20,0.85,9,61,70,19,14,5,15,34,115
2015,Lorenzo Brown\brownlo01,PG,25,PHO,8,0,61,8,25,0.32,1,8,0.125,7,17,0.412,0.34,3,4,0.75,0,7,7,11,3,1,9,4,20
2015,Markel Brown\brownma02,SG,24,BRK,62,6,982,127,322,0.394,38,121,0.314,89,201,0.443,0.453,71,94,0.755,23,99,122,91,38,15,54,94,363
2015,Kobe Bryant*\bryanko01,SF,37,LAL,66,66,1863,398,1113,0.358,133,467,0.285,265,646,0.41,0.417,232,281,0.826,41,206,247,184,62,13,129,115,1161
2015,Chase Budinger\budinch01,SF,27,TOT,66,2,929,104,239,0.435,24,86,0.279,80,153,0.523,0.485,39,56,0.696,43,107,150,64,32,10,44,62,271
2015,Chase Budinger\budinch01,SF,27,IND,49,2,729,81,194,0.418,20,69,0.29,61,125,0.488,0.469,34,48,0.708,31,90,121,49,29,9,31,46,216
2015,Chase Budinger\budinch01,SF,27,PHO,17,0,200,23,45,0.511,4,17,0.235,19,28,0.679,0.556,5,8,0.625,12,17,29,15,3,1,13,16,55
2015,Reggie Bullock\bullore01,SF,24,DET,37,0,429,43,98,0.439,22,53,0.415,21,45,0.467,0.551,14,15,0.933,14,54,68,27,10,2,8,29,122
2015,Trey Burke\burketr01,PG,23,UTA,64,0,1366,262,634,0.413,88,256,0.344,174,378,0.46,0.483,67,82,0.817,18,94,112,148,35,6,80,86,679
2015,Alec Burks\burksal01,SG,24,UTA,31,3,797,137,334,0.41,32,79,0.405,105,255,0.412,0.458,106,141,0.752,16,93,109,63,18,4,51,71,412
2015,Caron Butler\butleca01,SF,35,SAC,17,1,176,25,59,0.424,3,18,0.167,22,41,0.537,0.449,10,12,0.833,5,17,22,10,9,1,3,19,63
2015,Jimmy Butler\butleji01,SG,26,CHI,67,67,2474,470,1035,0.454,64,205,0.312,406,830,0.489,0.485,395,475,0.832,79,279,358,321,110,43,132,124,1399
2015,Rasual Butler\butlera01,SF,36,SAS,46,0,432,49,104,0.471,15,49,0.306,34,55,0.618,0.543,11,16,0.688,3,53,56,24,13,23,8,11,124
2015,Bruno Caboclo\cabocbr01,SF,20,TOR,6,1,43,1,12,0.083,1,7,0.143,0,5,0,0.125,0,0,,1,1,2,1,2,1,4,2,3
2015,José Calderón\caldejo01,PG,34,NYK,72,72,2024,209,455,0.459,84,203,0.414,125,252,0.496,0.552,42,48,0.875,22,207,229,298,63,7,87,135,544
2015,Kentavious Caldwell-Pope\caldwke01,SG,22,DET,76,76,2789,403,960,0.42,114,369,0.309,289,591,0.489,0.479,185,228,0.811,70,212,282,138,110,17,105,167,1105
2015,Isaiah Canaan\canaais01,SG,24,PHI,77,39,1966,260,722,0.36,176,485,0.363,84,237,0.354,0.482,150,180,0.833,20,154,174,137,56,12,91,133,846
2015,Clint Capela\capelca01,C,21,HOU,77,35,1471,231,397,0.582,0,1,0,231,396,0.583,0.582,80,211,0.379,194,300,494,47,59,92,60,190,542
2015,DeMarre Carroll\carrode01,SF,29,TOR,26,22,786,105,270,0.389,46,118,0.39,59,152,0.388,0.474,30,50,0.6,31,91,122,27,44,6,28,63,286
2015,Vince Carter\cartevi01,SG,39,MEM,60,3,1005,133,343,0.388,59,169,0.349,74,174,0.425,0.474,70,84,0.833,31,115,146,56,38,16,35,101,395
2015,Michael Carter-Williams\cartemi01,PG,24,MIL,54,37,1649,251,555,0.452,15,55,0.273,236,500,0.472,0.466,106,162,0.654,48,228,276,281,80,41,153,162,623
2015,Omri Casspi\casspom01,PF,27,SAC,69,21,1880,299,622,0.481,112,274,0.409,187,348,0.537,0.571,103,159,0.648,58,352,410,95,56,17,94,154,813
2015,Willie Cauley-Stein\caulewi01,C,22,SAC,66,39,1412,191,339,0.563,0,2,0,191,337,0.567,0.563,81,125,0.648,134,218,352,37,48,66,46,146,463
2015,Mario Chalmers\chalmma01,PG,29,TOT,61,7,1373,182,444,0.41,46,149,0.309,136,295,0.461,0.462,218,262,0.832,24,133,157,230,88,13,110,181,628
2015,Mario Chalmers\chalmma01,PG,29,MIA,6,0,120,10,32,0.313,1,11,0.091,9,21,0.429,0.328,12,13,0.923,1,13,14,19,8,1,9,16,33
2015,Mario Chalmers\chalmma01,PG,29,MEM,55,7,1253,172,412,0.417,45,138,0.326,127,274,0.464,0.472,206,249,0.827,23,120,143,211,80,12,101,165,595
2015,Tyson Chandler\chandty01,C,33,PHO,66,60,1618,183,314,0.583,0,1,0,183,313,0.585,0.583,106,171,0.62,175,401,576,64,36,44,93,145,472
2015,Rakeem Christmas\chrisra01,PF,24,IND,1,0,6,2,2,1,0,0,,2,2,1,1,0,0,,1,0,1,0,0,0,0,1,4
2015,Ian Clark\clarkia01,SG,24,GSW,66,1,578,89,202,0.441,30,84,0.357,59,118,0.5,0.515,28,34,0.824,13,55,68,64,17,13,43,58,236
2015,Coty Clarke\clarkco01,SF,23,BOS,3,0,6,2,4,0.5,2,2,1,0,2,0,0.75,0,0,,0,1,1,0,0,0,1,0,6
2015,Jordan Clarkson\clarkjo01,SG,23,LAL,79,79,2552,475,1098,0.433,111,320,0.347,364,778,0.468,0.483,164,204,0.804,93,220,313,192,88,7,135,168,1225
2015,Norris Cole\coleno01,PG,27,NOP,45,23,1198,196,484,0.405,33,102,0.324,163,382,0.427,0.439,52,65,0.8,10,141,151,167,37,5,75,102,477
2015,Darren Collison\collida01,PG,28,SAC,74,15,2219,377,776,0.486,87,217,0.401,290,559,0.519,0.542,194,226,0.858,28,141,169,318,76,4,130,142,1035
2015,Nick Collison\collini01,PF,35,OKC,59,4,699,50,109,0.459,0,2,0,50,107,0.467,0.459,23,33,0.697,68,103,171,52,15,16,50,107,123
2015,Mike Conley\conlemi01,PG,28,MEM,56,56,1761,294,696,0.422,78,215,0.363,216,481,0.449,0.478,191,229,0.834,26,138,164,342,67,16,84,100,857
2015,Pat Connaughton\connapa01,SG,23,POR,34,0,143,13,49,0.265,5,21,0.238,8,28,0.286,0.316,5,5,1,11,21,32,10,2,0,10,6,36
2015,Chris Copeland\copelch01,PF,31,MIL,24,1,156,17,51,0.333,10,36,0.278,7,15,0.467,0.431,6,7,0.857,1,9,10,11,2,0,6,17,50
2015,Bryce Cotton\cottobr01,PG,23,TOT,8,0,39,4,10,0.4,0,3,0,4,7,0.571,0.4,0,0,,0,0,0,3,3,0,5,2,8
2015,Bryce Cotton\cottobr01,PG,23,PHO,3,0,33,2,8,0.25,0,3,0,2,5,0.4,0.25,0,0,,0,0,0,3,3,0,5,2,4
2015,Bryce Cotton\cottobr01,PG,23,MEM,5,0,6,2,2,1,0,0,,2,2,1,1,0,0,,0,0,0,0,0,0,0,0,4
2015,DeMarcus Cousins\couside01,C,25,SAC,65,65,2246,601,1332,0.451,70,210,0.333,531,1122,0.473,0.477,476,663,0.718,158,589,747,214,101,92,249,236,1748
2015,Robert Covington\covinro01,SF,25,PHI,67,49,1903,274,712,0.385,170,482,0.353,104,230,0.452,0.504,140,177,0.791,65,354,419,97,105,40,143,232,858
2015,Allen Crabbe\crabbal01,SG,23,POR,81,8,2105,311,678,0.459,112,285,0.393,199,393,0.506,0.541,98,113,0.867,27,189,216,99,63,16,64,192,832
2015,Jamal Crawford\crawfja01,SG,35,LAC,79,5,2126,379,939,0.404,117,344,0.34,262,595,0.44,0.466,245,271,0.904,20,125,145,183,52,12,113,122,1120
2015,Jae Crowder\crowdja01,SF,25,BOS,73,73,2308,360,813,0.443,122,363,0.336,238,450,0.529,0.518,196,239,0.82,70,303,373,135,126,35,83,198,1038
2015,Dante Cunningham\cunnida01,SF,28,NOP,80,46,1971,186,412,0.451,55,174,0.316,131,238,0.55,0.518,57,82,0.695,57,179,236,77,42,33,41,173,484
2015,Jared Cunningham\cunnija01,SG,24,TOT,44,3,410,36,105,0.343,12,39,0.308,24,66,0.364,0.4,36,55,0.655,3,35,38,20,14,2,21,41,120
2015,Jared Cunningham\cunnija01,SG,24,CLE,40,3,355,32,91,0.352,10,32,0.313,22,59,0.373,0.407,30,48,0.625,3,26,29,19,12,2,18,37,104
2015,Jared Cunningham\cunnija01,SG,24,MIL,4,0,55,4,14,0.286,2,7,0.286,2,7,0.286,0.357,6,7,0.857,0,9,9,1,2,0,3,4,16
2015,Seth Curry\curryse01,PG,25,SAC,44,9,692,102,224,0.455,50,111,0.45,52,113,0.46,0.567,45,54,0.833,9,51,60,67,22,3,36,41,299
2015,Stephen Curry\curryst01,PG,27,GSW,79,79,2700,805,1598,0.504,402,886,0.454,403,712,0.566,0.63,363,400,0.908,68,362,430,527,169,15,262,161,2375
2015,Troy Daniels\danietr01,SG,24,CHO,43,0,476,89,187,0.476,59,122,0.484,30,65,0.462,0.634,5,9,0.556,7,50,57,21,11,3,24,40,242
2015,Anthony Davis\davisan02,C,22,NOP,61,61,2164,560,1136,0.493,35,108,0.324,525,1028,0.511,0.508,326,430,0.758,130,497,627,116,78,125,121,148,1481
2015,Ed Davis\davised01,PF,26,POR,81,0,1684,206,337,0.611,0,0,,206,337,0.611,0.611,114,204,0.559,224,375,599,88,57,72,64,202,526
2015,Branden Dawson\dawsobr01,PF,22,LAC,6,0,29,2,5,0.4,0,0,,2,5,0.4,0.4,1,1,1,2,2,4,0,0,1,0,2,5
2015,Dewayne Dedmon\dedmode01,C,26,ORL,58,20,705,99,177,0.559,0,0,,99,177,0.559,0.559,57,76,0.75,67,161,228,13,22,46,32,109,255
2015,Bryce Dejean-Jones\dejeabr01,SG,23,NOP,14,11,279,28,69,0.406,12,32,0.375,16,37,0.432,0.493,11,21,0.524,8,40,48,15,10,2,11,17,79
2015,Sam Dekker\dekkesa01,PF,21,HOU,3,0,6,0,0,,0,0,,0,0,,,0,0,,0,1,1,0,1,0,0,0,0
2015,Matthew Dellavedova\dellama01,PG,25,CLE,76,14,1867,207,511,0.405,98,239,0.41,109,272,0.401,0.501,57,66,0.864,33,129,162,337,44,9,116,178,569
2015,Luol Deng\denglu01,PF,30,MIA,74,73,2394,339,745,0.455,88,256,0.344,251,489,0.513,0.514,145,192,0.755,108,335,443,140,74,29,81,122,911
2015,DeMar DeRozan\derozde01,SG,26,TOR,78,78,2804,614,1377,0.446,47,139,0.338,567,1238,0.458,0.463,555,653,0.85,64,285,349,315,81,21,175,167,1830
2015,Boris Diaw\diawbo01,PF,33,SAS,76,4,1386,202,383,0.527,25,69,0.362,177,314,0.564,0.56,56,76,0.737,58,175,233,176,26,21,97,102,485
2015,Gorgui Dieng\dienggo01,C,26,MIN,82,39,2220,308,579,0.532,6,20,0.3,302,559,0.54,0.537,205,248,0.827,157,428,585,143,94,96,140,219,827
2015,Spencer Dinwiddie\dinwisp01,PG,22,DET,12,0,159,19,54,0.352,1,10,0.1,18,44,0.409,0.361,19,33,0.576,4,13,17,22,3,0,7,20,58
2015,Toney Douglas\douglto01,PG,29,NOP,61,18,1262,183,445,0.411,81,203,0.399,102,242,0.421,0.502,84,99,0.848,25,118,143,157,70,5,64,131,531
2015,Goran Dragić\dragigo01,PG,29,MIA,72,72,2363,417,875,0.477,64,205,0.312,353,670,0.527,0.513,120,165,0.727,54,223,277,419,71,17,185,188,1018
2015,Andre Drummond\drumman01,C,22,DET,81,81,2666,552,1060,0.521,2,6,0.333,550,1054,0.522,0.522,208,586,0.355,395,803,1198,67,119,112,155,245,1314
2015,Jared Dudley\dudleja01,PF,30,WAS,81,41,2098,233,487,0.478,100,238,0.42,133,249,0.534,0.581,72,98,0.735,54,232,286,170,75,18,80,190,638
2015,Duje Dukan\dukandu01,SF,24,SAC,1,0,24,2,10,0.2,2,5,0.4,0,5,0,0.3,0,0,,2,2,4,1,1,0,0,2,6
2015,Tim Duncan*\duncati01,C,39,SAS,61,60,1536,215,441,0.488,0,2,0,215,439,0.49,0.488,92,131,0.702,115,332,447,163,47,78,90,125,522
2015,Mike Dunleavy\dunlemi02,SF,35,CHI,31,30,703,77,188,0.41,39,99,0.394,38,89,0.427,0.513,29,37,0.784,8,75,83,39,14,10,26,66,222
2015,Kevin Durant\duranke01,SF,27,OKC,72,72,2578,698,1381,0.505,186,481,0.387,512,900,0.569,0.573,447,498,0.898,45,544,589,361,69,85,250,137,2029
2015,Cleanthony Early\earlycl01,SF,24,NYK,17,2,154,12,40,0.3,4,15,0.267,8,25,0.32,0.35,3,4,0.75,4,22,26,6,2,3,9,16,31
2015,Jarell Eddie\eddieja01,SF,24,WAS,26,0,147,20,65,0.308,15,47,0.319,5,18,0.278,0.423,8,8,1,2,21,23,5,5,1,1,5,63
2015,Wayne Ellington\ellinwa01,SG,28,BRK,76,41,1615,218,561,0.389,96,268,0.358,122,293,0.416,0.474,54,63,0.857,20,154,174,83,48,5,45,82,586
2015,Monta Ellis\ellismo01,SG,30,IND,81,81,2734,436,1021,0.427,87,282,0.309,349,739,0.472,0.47,162,206,0.786,42,229,271,383,150,37,203,174,1121
2015,James Ennis\ennisja01,SF,25,TOT,22,5,329,54,113,0.478,26,58,0.448,28,55,0.509,0.593,25,34,0.735,21,21,42,21,16,5,19,28,159
2015,James Ennis\ennisja01,SF,25,MIA,3,0,7,0,0,,0,0,,0,0,,,0,0,,0,0,0,1,0,0,0,1,0
2015,James Ennis\ennisja01,SF,25,MEM,10,0,40,4,13,0.308,2,8,0.25,2,5,0.4,0.385,6,10,0.6,4,3,7,2,4,2,2,1,16
2015,James Ennis\ennisja01,SF,25,NOP,9,5,282,50,100,0.5,24,50,0.48,26,50,0.52,0.62,19,24,0.792,17,18,35,18,12,3,17,26,143
2015,Tyler Ennis\ennisty01,PG,21,MIL,46,7,654,84,187,0.449,13,39,0.333,71,148,0.48,0.484,25,34,0.735,13,62,75,95,25,1,46,64,206
2015,Jeremy Evans\evansje01,SF,28,DAL,30,2,251,26,48,0.542,4,16,0.25,22,32,0.688,0.583,15,21,0.714,11,43,54,2,6,9,7,19,71
2015,Tyreke Evans\evansty01,SG,26,NOP,25,25,765,136,314,0.433,33,85,0.388,103,229,0.45,0.486,74,93,0.796,20,109,129,164,32,8,73,66,379
2015,Festus Ezeli\ezelife01,C,26,GSW,46,13,770,125,228,0.548,0,0,,125,228,0.548,0.548,70,132,0.53,91,166,257,32,18,50,38,94,320
2015,Kenneth Faried\farieke01,PF,26,DEN,67,64,1694,349,626,0.558,1,2,0.5,348,624,0.558,0.558,136,222,0.613,235,346,581,79,32,60,91,169,835
2015,Jordan Farmar\farmajo01,PG,29,MEM,12,10,291,42,100,0.42,16,45,0.356,26,55,0.473,0.5,10,10,1,4,21,25,37,15,2,18,22,110
2015,Derrick Favors\favorde01,PF,24,UTA,62,59,1983,418,811,0.515,0,4,0,418,807,0.518,0.515,180,254,0.709,169,334,503,94,74,91,104,150,1016
2015,Cristiano Felício\feliccr01,C,23,CHI,31,4,321,40,72,0.556,0,4,0,40,68,0.588,0.556,25,35,0.714,30,72,102,26,6,13,13,31,105
2015,Raymond Felton\feltora01,PG,31,DAL,80,31,2192,277,682,0.406,60,213,0.282,217,469,0.463,0.45,149,176,0.847,36,222,258,284,68,15,121,141,763
2015,Evan Fournier\fournev01,SF,23,ORL,79,71,2566,429,929,0.462,156,390,0.4,273,539,0.506,0.546,199,238,0.836,33,192,225,213,96,2,133,214,1213
2015,Randy Foye\foyera01,SG,32,TOT,81,8,1642,169,482,0.351,75,250,0.3,94,232,0.405,0.428,61,74,0.824,24,132,156,161,39,29,86,131,474
2015,Randy Foye\foyera01,SG,32,DEN,54,7,1070,117,333,0.351,50,169,0.296,67,164,0.409,0.426,39,47,0.83,16,89,105,112,26,16,58,83,323
2015,Randy Foye\foyera01,SG,32,OKC,27,1,572,52,149,0.349,25,81,0.309,27,68,0.397,0.433,22,27,0.815,8,43,51,49,13,13,28,48,151
2015,Tim Frazier\fraziti01,PG,25,TOT,51,2,741,96,229,0.419,16,48,0.333,80,181,0.442,0.454,53,74,0.716,26,84,110,162,33,2,65,73,261
2015,Tim Frazier\fraziti01,PG,25,POR,35,1,272,20,60,0.333,3,17,0.176,17,43,0.395,0.358,8,15,0.533,11,28,39,42,10,1,27,31,51
2015,Tim Frazier\fraziti01,PG,25,NOP,16,1,469,76,169,0.45,13,31,0.419,63,138,0.457,0.488,45,59,0.763,15,56,71,120,23,1,38,42,210
2015,Jimmer Fredette\fredeji01,SG,26,TOT,6,0,18,2,5,0.4,1,2,0.5,1,3,0.333,0.5,4,5,0.8,0,0,0,1,1,0,2,2,9
2015,Jimmer Fredette\fredeji01,SG,26,NOP,4,0,13,1,4,0.25,0,1,0,1,3,0.333,0.25,0,0,,0,0,0,1,1,0,1,1,2
2015,Jimmer Fredette\fredeji01,SG,26,NYK,2,0,5,1,1,1,1,1,1,0,0,,1.5,4,5,0.8,0,0,0,0,0,0,1,1,7
2015,Channing Frye\fryech01,PF-C,32,TOT,70,32,1200,152,347,0.438,91,235,0.387,61,112,0.545,0.569,30,35,0.857,35,199,234,71,29,28,43,127,425
2015,Channing Frye\fryech01,PF,32,ORL,44,29,754,81,186,0.435,48,121,0.397,33,65,0.508,0.565,19,21,0.905,23,118,141,45,21,20,30,71,229
2015,Channing Frye\fryech01,C,32,CLE,26,3,446,71,161,0.441,43,114,0.377,28,47,0.596,0.575,11,14,0.786,12,81,93,26,8,8,13,56,196
2015,Danilo Gallinari\gallida01,SF,27,DEN,53,53,1839,287,700,0.41,87,239,0.364,200,461,0.434,0.472,375,432,0.868,52,229,281,135,42,19,77,87,1036
2015,Langston Galloway\gallola01,PG,24,NYK,82,7,2033,231,588,0.393,77,224,0.344,154,364,0.423,0.458,86,114,0.754,43,245,288,207,77,22,61,177,625
2015,Kevin Garnett*\garneke01,PF,39,MIN,38,38,556,54,115,0.47,0,1,0,54,114,0.474,0.47,14,21,0.667,15,135,150,62,28,10,16,70,122
2015,Marc Gasol\gasolma01,C,31,MEM,52,52,1791,328,707,0.464,2,3,0.667,326,704,0.463,0.465,203,245,0.829,58,304,362,196,50,70,118,141,861
2015,Pau Gasol\gasolpa01,C,35,CHI,72,72,2291,467,995,0.469,24,69,0.348,443,926,0.478,0.481,229,289,0.792,155,638,793,294,42,146,164,148,1187
2015,Rudy Gay\gayru01,SF,29,SAC,70,70,2379,466,1007,0.463,74,215,0.344,392,792,0.495,0.5,198,254,0.78,103,353,456,120,100,51,139,184,1204
2015,Alonzo Gee\geeal01,SF,28,NOP,73,38,1632,132,255,0.518,17,60,0.283,115,195,0.59,0.551,44,66,0.667,60,185,245,72,63,13,55,169,325
2015,Paul George\georgpa01,SF,25,IND,81,81,2819,605,1449,0.418,210,566,0.371,395,883,0.447,0.49,454,528,0.86,79,484,563,329,152,29,265,230,1874
2015,Taj Gibson\gibsota01,PF,30,CHI,73,55,1936,263,500,0.526,0,3,0,263,497,0.529,0.526,101,146,0.692,206,298,504,106,47,77,78,180,627
2015,Manu Ginóbili\ginobma01,SG,38,SAS,58,0,1134,197,435,0.453,70,179,0.391,127,256,0.496,0.533,91,112,0.813,26,120,146,177,66,11,99,99,555
2015,Rudy Gobert\goberru01,C,23,UTA,61,60,1932,198,354,0.559,0,0,,198,354,0.559,0.559,161,283,0.569,208,460,668,91,45,135,114,163,557
2015,Drew Gooden\goodedr01,PF,34,WAS,30,0,305,33,103,0.32,7,41,0.171,26,62,0.419,0.354,9,14,0.643,28,57,85,13,8,11,13,40,82
2015,Archie Goodwin\goodwar01,PG,21,PHO,57,13,1114,176,422,0.417,23,99,0.232,153,323,0.474,0.444,130,193,0.674,27,115,142,118,27,13,100,84,505
2015,Aaron Gordon\gordoaa01,PF,20,ORL,78,37,1863,274,579,0.473,42,142,0.296,232,437,0.531,0.509,129,193,0.668,154,353,507,128,59,55,66,153,719
2015,Eric Gordon\gordoer01,SG,27,NOP,45,44,1481,231,552,0.418,113,294,0.384,118,258,0.457,0.521,111,125,0.888,10,89,99,121,43,14,73,98,686
2015,Marcin Gortat\gortama01,C,31,WAS,75,74,2256,433,764,0.567,0,1,0,433,763,0.567,0.567,146,207,0.705,222,519,741,106,47,96,121,193,1012
2015,Andrew Goudelock\goudean01,PG,27,HOU,8,0,50,9,20,0.45,1,9,0.111,8,11,0.727,0.475,3,4,0.75,1,1,2,4,6,2,7,4,22
2015,Jerami Grant\grantje01,PF,21,PHI,77,52,2066,251,599,0.419,35,146,0.24,216,453,0.477,0.448,212,322,0.658,99,262,361,135,54,127,110,215,749
2015,Jerian Grant\grantje02,PG,23,NYK,76,6,1265,154,391,0.394,22,100,0.22,132,291,0.454,0.422,96,123,0.78,23,120,143,177,50,10,87,97,426
2015,Danny Green\greenda02,SG,28,SAS,79,79,2062,211,561,0.376,116,349,0.332,95,212,0.448,0.48,34,46,0.739,48,255,303,141,79,64,75,141,572
2015,Draymond Green\greendr01,PF,25,GSW,81,81,2808,401,819,0.49,100,258,0.388,301,561,0.537,0.551,229,329,0.696,134,635,769,598,119,113,259,240,1131
2015,Erick Green\greener01,PG,24,TOT,9,0,42,5,13,0.385,1,5,0.2,4,8,0.5,0.423,2,2,1,3,3,6,3,1,0,0,4,13
2015,Erick Green\greener01,PG,24,DEN,3,0,7,0,1,0,0,1,0,0,0,,0,0,0,,0,1,1,1,0,0,0,0,0
2015,Erick Green\greener01,PG,24,UTA,6,0,35,5,12,0.417,1,4,0.25,4,8,0.5,0.458,2,2,1,3,2,5,2,1,0,0,4,13
2015,Gerald Green\greenge01,SG,30,MIA,69,14,1557,230,587,0.392,84,260,0.323,146,327,0.446,0.463,72,92,0.783,25,138,163,56,38,19,46,123,616
2015,JaMychal Green\greenja01,PF,25,MEM,78,15,1446,230,495,0.465,15,45,0.333,215,450,0.478,0.48,103,137,0.752,139,234,373,67,46,33,83,189,578
2015,Jeff Green\greenje02,SF,29,TOT,80,41,2253,354,824,0.43,67,213,0.315,287,611,0.47,0.47,164,220,0.745,74,258,332,138,58,40,93,164,939
2015,Jeff Green\greenje02,SF,29,MEM,53,31,1544,240,557,0.431,42,136,0.309,198,421,0.47,0.469,124,155,0.8,55,186,241,98,40,19,69,102,646
2015,Jeff Green\greenje02,SF,29,LAC,27,10,709,114,267,0.427,25,77,0.325,89,190,0.468,0.474,40,65,0.615,19,72,91,40,18,21,24,62,293
2015,Blake Griffin\griffbl01,PF,26,LAC,35,35,1170,301,603,0.499,6,18,0.333,295,585,0.504,0.504,141,194,0.727,51,243,294,170,28,17,83,95,749
2015,Jorge Gutiérrez\gutiejo01,PG,27,CHO,12,0,63,6,11,0.545,0,2,0,6,9,0.667,0.545,10,11,0.909,0,7,7,17,3,0,6,3,22
2015,P.J. Hairston\hairspj02,SF,23,TOT,66,52,1313,145,408,0.355,70,241,0.29,75,167,0.449,0.441,50,64,0.781,25,149,174,38,32,11,41,137,410
2015,P.J. Hairston\hairspj02,SF,23,CHO,48,43,938,99,276,0.359,54,172,0.314,45,104,0.433,0.457,34,42,0.81,18,110,128,29,24,7,24,106,286
2015,P.J. Hairston\hairspj02,SF,23,MEM,18,9,375,46,132,0.348,16,69,0.232,30,63,0.476,0.409,16,22,0.727,7,39,46,9,8,4,17,31,124
2015,Jordan Hamilton\hamiljo02,SF,25,NOP,11,4,304,49,116,0.422,13,45,0.289,36,71,0.507,0.478,14,21,0.667,12,50,62,25,8,3,17,24,125
2015,Tyler Hansbrough\hansbty01,PF,30,CHO,44,0,343,32,71,0.451,2,3,0.667,30,68,0.441,0.465,38,65,0.585,40,49,89,8,12,7,12,55,104
2015,Tim Hardaway Jr.\hardati02,SG,23,ATL,51,1,864,114,265,0.43,48,142,0.338,66,123,0.537,0.521,50,56,0.893,7,79,86,51,21,7,23,48,326
2015,James Harden\hardeja01,SG,26,HOU,82,82,3125,710,1617,0.439,236,657,0.359,474,960,0.494,0.512,720,837,0.86,63,438,501,612,139,51,374,229,2376
2015,Maurice Harkless\harklma01,SF,22,POR,78,14,1457,195,411,0.474,39,140,0.279,156,271,0.576,0.522,69,111,0.622,101,179,280,67,49,35,62,124,498
2015,Justin Harper\harpeju01,PF,26,DET,5,0,35,4,10,0.4,4,9,0.444,0,1,0,0.6,1,2,0.5,0,1,1,0,1,0,2,3,13
2015,Montrezl Harrell\harremo01,PF,22,HOU,39,1,379,58,90,0.644,0,1,0,58,89,0.652,0.644,24,46,0.522,25,40,65,17,11,11,17,48,140
2015,Devin Harris\harride01,PG,32,DAL,64,0,1280,167,374,0.447,52,158,0.329,115,216,0.532,0.516,101,140,0.721,18,120,138,118,60,13,66,124,487
2015,Gary Harris\harriga01,SG,21,DEN,76,76,2439,359,765,0.469,105,297,0.354,254,468,0.543,0.538,109,133,0.82,54,166,220,147,97,18,98,143,932
2015,Joe Harris\harrijo01,SG,24,CLE,5,0,15,1,4,0.25,1,4,0.25,0,0,,0.375,0,0,,0,3,3,2,0,0,1,1,3
2015,Tobias Harris\harrito02,PF,23,TOT,76,74,2513,417,889,0.469,80,239,0.335,337,650,0.518,0.514,202,243,0.831,96,414,510,169,65,40,108,153,1116
2015,Tobias Harris\harrito02,PF,23,ORL,49,49,1610,251,541,0.464,47,151,0.311,204,390,0.523,0.507,120,153,0.784,71,271,342,99,47,28,78,91,669
2015,Tobias Harris\harrito02,PF,23,DET,27,25,903,166,348,0.477,33,88,0.375,133,260,0.512,0.524,82,90,0.911,25,143,168,70,18,12,30,62,447
2015,Aaron Harrison\harriaa01,SG,21,CHO,21,0,93,5,19,0.263,3,10,0.3,2,9,0.222,0.342,5,12,0.417,4,11,15,2,6,0,4,10,18
2015,Udonis Haslem\hasleud01,PF,35,MIA,37,0,260,23,61,0.377,1,9,0.111,22,52,0.423,0.385,12,16,0.75,10,65,75,14,5,2,5,25,59
2015,Spencer Hawes\hawessp01,PF,27,CHO,57,6,1035,124,306,0.405,38,102,0.373,86,204,0.422,0.467,54,65,0.831,51,193,244,109,22,27,58,111,340
2015,Chuck Hayes\hayesch01,C,32,HOU,2,0,24,1,2,0.5,0,0,,1,2,0.5,0.5,2,2,1,0,8,8,2,0,0,3,6,4
2015,Gordon Hayward\haywago01,SF,25,UTA,80,80,2893,521,1202,0.433,143,410,0.349,378,792,0.477,0.493,393,477,0.824,61,336,397,296,95,27,202,183,1578
2015,Gerald Henderson\hendege02,SG,28,POR,72,0,1431,232,529,0.439,48,136,0.353,184,393,0.468,0.484,112,146,0.767,30,181,211,75,39,19,68,87,624
2015,John Henson\hensojo01,C,25,MIL,57,1,960,164,291,0.564,0,1,0,164,290,0.566,0.564,69,117,0.59,87,134,221,54,18,109,64,131,397
2015,Mario Hezonja\hezonma01,SF,20,ORL,79,9,1413,181,418,0.433,67,192,0.349,114,226,0.504,0.513,49,54,0.907,28,148,176,109,39,17,97,124,478
2015,Roy Hibbert\hibbero01,C,29,LAL,81,81,1878,182,411,0.443,0,2,0,182,409,0.445,0.443,117,145,0.807,132,266,398,95,32,110,76,252,481
2015,J.J. Hickson\hicksjj01,C,27,TOT,35,9,436,80,155,0.516,0,1,0,80,154,0.519,0.516,46,103,0.447,39,93,132,23,15,14,25,47,206
2015,J.J. Hickson\hicksjj01,C,27,DEN,20,9,305,55,109,0.505,0,0,,55,109,0.505,0.505,27,59,0.458,22,65,87,16,10,12,16,35,137
2015,J.J. Hickson\hicksjj01,C,27,WAS,15,0,131,25,46,0.543,0,1,0,25,45,0.556,0.543,19,44,0.432,17,28,45,7,5,2,9,12,69
2015,Nenê\hilarne01,PF,33,WAS,57,11,1094,209,384,0.544,0,3,0,209,381,0.549,0.544,107,185,0.578,52,207,259,97,54,26,76,156,525
2015,George Hill\hillge01,PG,29,IND,74,73,2524,326,739,0.441,128,314,0.408,198,425,0.466,0.528,114,150,0.76,58,240,298,259,83,17,101,149,894
2015,Jordan Hill\hilljo01,C,28,IND,73,11,1513,278,549,0.506,0,1,0,278,548,0.507,0.506,89,125,0.712,156,295,451,87,36,37,92,155,645
2015,Solomon Hill\hillso01,SF,24,IND,59,3,866,93,208,0.447,24,74,0.324,69,134,0.515,0.505,36,42,0.857,39,127,166,57,37,11,33,68,246
2015,Darrun Hilliard\hillida01,SG,22,DET,38,2,383,52,131,0.397,19,50,0.38,33,81,0.407,0.469,29,40,0.725,5,40,45,27,9,1,19,28,152
2015,Kirk Hinrich\hinriki01,PG,35,TOT,46,7,631,49,129,0.38,24,62,0.387,25,67,0.373,0.473,15,16,0.938,8,62,70,73,15,2,30,64,137
2015,Kirk Hinrich\hinriki01,PG,35,CHI,35,7,555,47,118,0.398,23,56,0.411,24,62,0.387,0.496,15,16,0.938,7,51,58,59,13,1,27,63,132
2015,Kirk Hinrich\hinriki01,PG,35,ATL,11,0,76,2,11,0.182,1,6,0.167,1,5,0.2,0.227,0,0,,1,11,12,14,2,1,3,1,5
2015,Jrue Holiday\holidjr01,PG,25,NOP,65,23,1831,410,935,0.439,87,259,0.336,323,676,0.478,0.485,182,216,0.843,27,168,195,391,88,22,167,148,1089
2015,Justin Holiday\holidju01,SG,26,TOT,53,5,773,88,228,0.386,36,105,0.343,52,123,0.423,0.465,27,37,0.73,12,78,90,56,32,19,39,61,239
2015,Justin Holiday\holidju01,SG,26,ATL,26,1,263,24,73,0.329,10,45,0.222,14,28,0.5,0.397,5,10,0.5,4,23,27,11,13,4,13,21,63
2015,Justin Holiday\holidju01,SG,26,CHI,27,4,510,64,155,0.413,26,60,0.433,38,95,0.4,0.497,22,27,0.815,8,55,63,45,19,15,26,40,176
2015,Ryan Hollins\holliry01,C,31,TOT,37,12,460,49,79,0.62,0,0,,49,79,0.62,0.62,26,42,0.619,47,51,98,10,6,21,24,62,124
2015,Ryan Hollins\holliry01,C,31,WAS,5,3,48,4,7,0.571,0,0,,4,7,0.571,0.571,0,0,,7,4,11,0,0,1,3,4,8
2015,Ryan Hollins\holliry01,C,31,MEM,32,9,412,45,72,0.625,0,0,,45,72,0.625,0.625,26,42,0.619,40,47,87,10,6,20,21,58,116
2015,Rondae Hollis-Jefferson\holliro01,SF,21,BRK,29,17,615,63,138,0.457,4,14,0.286,59,124,0.476,0.471,37,52,0.712,39,115,154,43,39,16,26,61,167
2015,Richaun Holmes\holmeri01,PF,22,PHI,51,1,702,114,222,0.514,8,44,0.182,106,178,0.596,0.532,51,74,0.689,62,73,135,33,19,40,32,92,287
2015,Rodney Hood\hoodro01,SG,23,UTA,79,79,2541,408,972,0.42,161,449,0.359,247,523,0.472,0.503,172,200,0.86,38,229,267,213,73,16,125,202,1149
2015,Al Horford\horfoal01,C,29,ATL,82,82,2631,529,1048,0.505,88,256,0.344,441,792,0.557,0.547,103,129,0.798,148,448,596,263,68,121,107,163,1249
2015,Dwight Howard\howardw01,C,30,HOU,71,71,2280,372,600,0.62,0,6,0,372,594,0.626,0.62,232,474,0.489,238,597,835,98,69,113,166,219,976
2015,Marcelo Huertas\huertma01,PG,32,LAL,53,0,869,97,230,0.422,16,61,0.262,81,169,0.479,0.457,27,29,0.931,18,72,90,182,26,7,80,76,237
2015,Josh Huestis\huestjo01,PF,24,OKC,5,0,55,5,12,0.417,4,6,0.667,1,6,0.167,0.583,0,4,0,2,8,10,0,1,2,3,3,14
2015,Kris Humphries\humphkr01,PF,30,TOT,53,17,835,121,295,0.41,34,108,0.315,87,187,0.465,0.468,67,84,0.798,57,161,218,36,16,23,38,94,343
2015,Kris Humphries\humphkr01,PF,30,WAS,28,14,466,64,158,0.405,23,67,0.343,41,91,0.451,0.478,29,31,0.935,26,89,115,16,3,14,20,42,180
2015,Kris Humphries\humphkr01,PF,30,PHO,4,3,74,10,36,0.278,3,10,0.3,7,26,0.269,0.319,6,8,0.75,11,21,32,7,3,2,4,8,29
2015,Kris Humphries\humphkr01,PF,30,ATL,21,0,295,47,101,0.465,8,31,0.258,39,70,0.557,0.505,32,45,0.711,20,51,71,13,10,7,14,44,134
2015,R.J. Hunter\hunterj01,SG,22,BOS,36,0,315,36,98,0.367,19,63,0.302,17,35,0.486,0.464,6,7,0.857,2,35,37,13,14,4,11,29,97
2015,Serge Ibaka\ibakase01,PF,26,OKC,78,78,2500,416,869,0.479,60,184,0.326,356,685,0.52,0.513,91,121,0.752,141,392,533,66,38,148,108,211,983
2015,Andre Iguodala\iguodan01,SF,32,GSW,65,1,1732,176,368,0.478,54,154,0.351,122,214,0.57,0.552,51,83,0.614,52,211,263,219,73,19,79,102,457
2015,Ersan İlyasova\ilyaser01,PF,28,TOT,74,56,1881,280,661,0.424,96,259,0.371,184,402,0.458,0.496,111,154,0.721,144,259,403,67,52,33,71,171,767
2015,Ersan İlyasova\ilyaser01,PF,28,DET,52,52,1434,216,508,0.425,78,215,0.363,138,293,0.471,0.502,79,109,0.725,99,183,282,55,38,27,59,120,589
2015,Ersan İlyasova\ilyaser01,PF,28,ORL,22,4,447,64,153,0.418,18,44,0.409,46,109,0.422,0.477,32,45,0.711,45,76,121,12,14,6,12,51,178
2015,Joe Ingles\inglejo01,SF,28,UTA,81,2,1241,124,291,0.426,81,210,0.386,43,81,0.531,0.565,13,18,0.722,19,132,151,96,55,4,65,98,342
2015,Damien Inglis\inglida01,SF,20,MIL,20,1,156,13,37,0.351,3,13,0.231,10,24,0.417,0.392,7,8,0.875,2,29,31,10,6,3,11,11,36
2015,Kyrie Irving\irvinky01,PG,23,CLE,53,53,1667,394,879,0.448,84,262,0.321,310,617,0.502,0.496,169,191,0.885,44,113,157,249,56,18,124,107,1041
2015,Jarrett Jack\jackja01,PG,32,BRK,32,32,1027,140,358,0.391,31,102,0.304,109,256,0.426,0.434,100,112,0.893,9,127,136,236,34,7,94,77,411
2015,Reggie Jackson\jacksre01,PG,25,DET,79,79,2424,540,1244,0.434,118,334,0.353,422,910,0.464,0.482,291,337,0.864,58,195,253,492,59,11,223,187,1489
2015,LeBron James\jamesle01,SF,31,CLE,76,76,2709,737,1416,0.52,87,282,0.309,650,1134,0.573,0.551,359,491,0.731,111,454,565,514,104,49,249,143,1920
2015,Al Jefferson\jeffeal01,C,31,CHO,47,18,1096,245,505,0.485,0,0,,245,505,0.485,0.485,72,111,0.649,57,244,301,70,30,41,34,117,562
2015,Cory Jefferson\jeffeco01,PF,25,PHO,8,0,50,9,22,0.409,0,1,0,9,21,0.429,0.409,4,6,0.667,6,10,16,0,0,1,0,8,22
2015,Richard Jefferson\jefferi01,SF,35,CLE,74,5,1326,143,312,0.458,66,173,0.382,77,139,0.554,0.564,58,87,0.667,15,113,128,59,33,14,43,129,410
2015,John Jenkins\jenkijo01,SG,24,TOT,43,3,480,71,160,0.444,16,51,0.314,55,109,0.505,0.494,20,24,0.833,8,49,57,35,8,1,27,22,178
2015,John Jenkins\jenkijo01,SG,24,DAL,21,1,193,29,70,0.414,3,19,0.158,26,51,0.51,0.436,8,9,0.889,4,18,22,9,3,0,11,11,69
2015,John Jenkins\jenkijo01,SG,24,PHO,22,2,287,42,90,0.467,13,32,0.406,29,58,0.5,0.539,12,15,0.8,4,31,35,26,5,1,16,11,109
2015,Brandon Jennings\jennibr01,PG,26,TOT,48,7,868,112,304,0.368,51,155,0.329,61,149,0.409,0.452,57,78,0.731,16,80,96,170,29,7,57,57,332
2015,Brandon Jennings\jennibr01,PG,26,DET,23,1,416,53,143,0.371,24,77,0.312,29,66,0.439,0.455,27,38,0.711,5,41,46,70,11,2,22,24,157
2015,Brandon Jennings\jennibr01,PG,26,ORL,25,6,452,59,161,0.366,27,78,0.346,32,83,0.386,0.45,30,40,0.75,11,39,50,100,18,5,35,33,175
2015,Jonas Jerebko\jerebjo01,PF,28,BOS,78,0,1176,118,286,0.413,43,108,0.398,75,178,0.421,0.488,61,78,0.782,77,211,288,62,20,24,52,137,340
2015,Amir Johnson\johnsam01,PF,28,BOS,79,76,1800,249,426,0.585,10,43,0.233,239,383,0.624,0.596,69,121,0.57,178,327,505,138,52,83,94,214,577
2015,Chris Johnson\johnsch04,SF,25,UTA,70,2,857,72,194,0.371,27,99,0.273,45,95,0.474,0.441,34,42,0.81,27,105,132,45,32,20,40,100,205
2015,James Johnson\johnsja01,PF,28,TOR,57,32,926,114,240,0.475,20,66,0.303,94,174,0.54,0.517,39,68,0.574,28,98,126,67,29,33,54,84,287
2015,Joe Johnson\johnsjo02,SF,34,TOT,81,81,2703,377,859,0.439,120,313,0.383,257,546,0.471,0.509,118,142,0.831,49,243,292,318,61,4,159,146,992
2015,Joe Johnson\johnsjo02,SF,34,BRK,57,57,1934,247,608,0.406,85,229,0.371,162,379,0.427,0.476,92,108,0.852,34,190,224,232,40,2,116,100,671
2015,Joe Johnson\johnsjo02,SF,34,MIA,24,24,769,130,251,0.518,35,84,0.417,95,167,0.569,0.588,26,34,0.765,15,53,68,86,21,2,43,46,321
2015,Orlando Johnson\johnsor01,SG,26,TOT,7,1,101,9,34,0.265,2,10,0.2,7,24,0.292,0.294,6,8,0.75,4,11,15,2,3,3,4,9,26
2015,Orlando Johnson\johnsor01,SG,26,PHO,2,0,47,5,17,0.294,1,5,0.2,4,12,0.333,0.324,5,6,0.833,3,6,9,0,2,3,1,5,16
2015,Orlando Johnson\johnsor01,SG,26,NOP,5,1,54,4,17,0.235,1,5,0.2,3,12,0.25,0.265,1,2,0.5,1,5,6,2,1,0,3,4,10
2015,Stanley Johnson\johnsst04,SF,19,DET,73,6,1687,225,600,0.375,63,205,0.307,162,395,0.41,0.428,80,102,0.784,58,248,306,118,55,12,114,178,593
2015,Tyler Johnson\johnsty01,SG,23,MIA,36,5,863,118,243,0.486,27,71,0.38,91,172,0.529,0.541,51,64,0.797,28,81,109,79,24,14,47,66,314
2015,Wesley Johnson\johnswe01,SF,28,LAC,80,9,1666,208,515,0.404,103,309,0.333,105,206,0.51,0.504,30,46,0.652,37,211,248,49,89,56,54,173,549
2015,Nikola Jokić\jokicni01,C,20,DEN,80,55,1733,307,600,0.512,28,84,0.333,279,516,0.541,0.535,154,190,0.811,181,379,560,189,79,50,104,208,796
2015,Dahntay Jones\jonesda02,SF,35,CLE,1,0,42,6,14,0.429,1,2,0.5,5,12,0.417,0.464,0,0,,1,4,5,2,1,2,0,6,13
2015,James Jones\jonesja02,SF,35,CLE,48,0,463,58,142,0.408,41,104,0.394,17,38,0.447,0.553,21,26,0.808,8,42,50,14,11,10,13,50,178
2015,Terrence Jones\joneste01,PF,24,HOU,50,11,1044,166,367,0.452,25,79,0.316,141,288,0.49,0.486,77,116,0.664,62,149,211,41,23,39,49,86,434
2015,Tyus Jones\jonesty01,PG,19,MIN,37,0,573,56,156,0.359,16,53,0.302,40,103,0.388,0.41,28,39,0.718,7,40,47,108,31,3,33,33,156
2015,DeAndre Jordan\jordade01,C,27,LAC,77,77,2598,357,508,0.703,0,1,0,357,507,0.704,0.703,266,619,0.43,267,792,1059,90,51,177,107,207,980
2015,Cory Joseph\josepco01,SG,24,TOR,80,4,2046,257,585,0.439,30,110,0.273,227,475,0.478,0.465,133,174,0.764,39,171,210,250,63,20,102,131,677
2015,Chris Kaman\kamanch01,C,33,POR,16,2,112,20,43,0.465,1,4,0.25,19,39,0.487,0.477,3,3,1,7,17,24,11,1,1,8,15,44
2015,Frank Kaminsky\kaminfr01,C,22,CHO,81,3,1708,215,525,0.41,68,202,0.337,147,323,0.455,0.474,108,148,0.73,69,266,335,98,38,43,58,126,606
2015,Enes Kanter\kanteen01,C,23,OKC,82,1,1721,414,719,0.576,10,21,0.476,404,698,0.579,0.583,200,251,0.797,249,415,664,33,26,33,115,166,1038
2015,Sergey Karasev\karasse01,SF,22,BRK,40,5,399,30,74,0.405,11,37,0.297,19,37,0.514,0.48,26,28,0.929,8,50,58,35,6,2,22,27,97
2015,Sasha Kaun\kaunsa01,C,30,CLE,25,0,95,9,17,0.529,0,0,,9,17,0.529,0.529,5,11,0.455,12,14,26,3,4,5,7,11,23
2015,Ryan Kelly\kellyry01,PF,24,LAL,36,0,470,55,149,0.369,5,37,0.135,50,112,0.446,0.386,37,54,0.685,21,100,121,20,13,10,18,39,152
2015,Michael Kidd-Gilchrist\kiddgmi01,SF,22,CHO,7,7,205,33,61,0.541,3,7,0.429,30,54,0.556,0.566,20,29,0.69,12,33,45,9,3,3,8,9,89
2015,Sean Kilpatrick\kilpase01,SG,26,TOT,31,0,616,123,270,0.456,39,114,0.342,84,156,0.538,0.528,60,67,0.896,12,44,56,29,12,2,31,37,345
2015,Sean Kilpatrick\kilpase01,SG,26,DEN,8,0,82,8,21,0.381,4,17,0.235,4,4,1,0.476,7,8,0.875,2,4,6,3,2,0,4,7,27
2015,Sean Kilpatrick\kilpase01,SG,26,BRK,23,0,534,115,249,0.462,35,97,0.361,80,152,0.526,0.532,53,59,0.898,10,40,50,26,10,2,27,30,318
2015,Brandon Knight\knighbr03,SG,24,PHO,52,50,1870,371,895,0.415,120,351,0.342,251,544,0.461,0.482,156,183,0.852,36,166,202,263,61,20,177,124,1018
2015,Kyle Korver\korveky01,SG,34,ATL,80,80,2401,268,616,0.435,158,397,0.398,110,219,0.502,0.563,45,54,0.833,14,246,260,164,60,35,98,161,739
2015,Kosta Koufos\koufoko01,C,26,SAC,78,14,1482,236,444,0.532,0,0,,236,444,0.532,0.532,57,104,0.548,169,254,423,33,40,70,48,185,529
2015,Jeremy Lamb\lambje01,SG,23,CHO,66,0,1227,230,510,0.451,56,181,0.309,174,329,0.529,0.506,64,88,0.727,44,208,252,77,42,30,50,105,580
2015,Carl Landry\landrca01,PF,32,PHI,36,12,569,139,250,0.556,6,13,0.462,133,237,0.561,0.568,67,91,0.736,49,97,146,32,12,9,22,69,351
2015,Shane Larkin\larkish01,PG,23,BRK,78,17,1751,222,502,0.442,39,108,0.361,183,394,0.464,0.481,83,107,0.776,28,152,180,342,95,12,146,121,566
2015,Joffrey Lauvergne\lauvejo01,C,24,DEN,59,15,1041,195,380,0.513,13,53,0.245,182,327,0.557,0.53,62,69,0.899,77,213,290,56,13,15,54,115,465
2015,Zach LaVine\lavinza01,SG,20,MIN,82,33,2294,433,959,0.452,123,316,0.389,310,643,0.482,0.516,161,203,0.793,27,201,228,251,69,17,155,193,1150
2015,Ty Lawson\lawsoty01,PG,28,TOT,66,13,1411,139,354,0.393,36,108,0.333,103,246,0.419,0.444,59,86,0.686,26,94,120,237,53,7,95,87,373
2015,Ty Lawson\lawsoty01,PG,28,HOU,53,12,1176,111,287,0.387,31,94,0.33,80,193,0.415,0.441,56,80,0.7,20,69,89,180,43,6,82,71,309
2015,Ty Lawson\lawsoty01,PG,28,IND,13,1,235,28,67,0.418,5,14,0.357,23,53,0.434,0.455,3,6,0.5,6,25,31,57,10,1,13,16,64
2015,Courtney Lee\leeco01,SG,30,TOT,79,65,2334,290,639,0.454,82,217,0.378,208,422,0.493,0.518,99,118,0.839,29,176,205,136,85,28,72,134,761
2015,Courtney Lee\leeco01,SG,30,MEM,51,37,1489,192,419,0.458,51,138,0.37,141,281,0.502,0.519,76,92,0.826,19,99,118,76,52,16,49,79,511
2015,Courtney Lee\leeco01,SG,30,CHO,28,28,845,98,220,0.445,31,79,0.392,67,141,0.475,0.516,23,26,0.885,10,77,87,60,33,12,23,55,250
2015,David Lee\leeda02,PF,32,TOT,55,5,903,178,335,0.531,0,1,0,178,334,0.533,0.531,71,93,0.763,101,204,305,84,22,28,66,114,427
2015,David Lee\leeda02,PF,32,BOS,30,4,470,87,192,0.453,0,1,0,87,191,0.455,0.453,40,51,0.784,41,89,130,54,12,13,38,51,214
2015,David Lee\leeda02,PF,32,DAL,25,1,433,91,143,0.636,0,0,,91,143,0.636,0.636,31,42,0.738,60,115,175,30,10,15,28,63,213
2015,Alex Len\lenal01,C,22,PHO,78,46,1821,264,624,0.423,1,7,0.143,263,617,0.426,0.424,174,239,0.728,178,416,594,97,38,62,145,230,703
2015,Kawhi Leonard\leonaka01,SF,24,SAS,72,72,2380,551,1090,0.506,129,291,0.443,422,799,0.528,0.565,292,334,0.874,95,398,493,186,128,71,105,133,1523
2015,Meyers Leonard\leoname01,PF,23,POR,61,10,1333,195,435,0.448,86,228,0.377,109,207,0.527,0.547,35,46,0.761,51,263,314,92,8,18,77,183,511
2015,Jon Leuer\leuerjo01,PF,26,PHO,67,27,1255,224,466,0.481,42,110,0.382,182,356,0.511,0.526,77,101,0.762,76,297,373,72,38,30,75,125,567
2015,Damian Lillard\lillada01,PG,25,POR,75,75,2676,618,1474,0.419,229,610,0.375,389,864,0.45,0.497,414,464,0.892,45,257,302,512,65,28,242,165,1879
2015,Jeremy Lin\linje01,SG,27,CHO,78,13,2048,300,728,0.412,76,226,0.336,224,502,0.446,0.464,238,292,0.815,42,211,253,235,58,42,150,165,914
2015,Shaun Livingston\livinsh01,PG,30,GSW,78,3,1520,203,379,0.536,2,12,0.167,201,367,0.548,0.538,80,93,0.86,42,127,169,237,57,27,78,140,488
2015,Kevon Looney\looneke01,PF,19,GSW,5,0,21,4,7,0.571,1,2,0.5,3,5,0.6,0.643,0,0,,4,6,10,0,0,0,1,2,9
2015,Brook Lopez\lopezbr01,C,27,BRK,73,73,2457,591,1157,0.511,2,14,0.143,589,1143,0.515,0.512,317,403,0.787,204,369,573,147,58,124,175,215,1501
2015,Robin Lopez\lopezro01,C,27,NYK,82,82,2219,357,662,0.539,0,1,0,357,661,0.54,0.539,128,161,0.795,268,334,602,114,16,129,133,182,842
2015,Kevin Love\loveke01,PF,27,CLE,77,77,2424,409,977,0.419,158,439,0.36,251,538,0.467,0.499,258,314,0.822,149,613,762,186,58,41,142,159,1234
2015,Kyle Lowry\lowryky01,PG,29,TOR,77,77,2851,512,1198,0.427,212,547,0.388,300,651,0.461,0.516,398,491,0.811,55,310,365,494,158,34,225,211,1634
2015,Trey Lyles\lylestr01,PF,20,UTA,80,33,1382,191,436,0.438,49,128,0.383,142,308,0.461,0.494,57,82,0.695,59,240,299,59,26,18,65,114,488
2015,Shelvin Mack\macksh01,PG,25,TOT,52,27,1058,182,415,0.439,39,125,0.312,143,290,0.493,0.486,45,61,0.738,13,115,128,187,34,3,95,72,448
2015,Shelvin Mack\macksh01,PG,25,ATL,24,0,179,40,95,0.421,4,27,0.148,36,68,0.529,0.442,9,12,0.75,2,20,22,38,8,0,14,7,93
2015,Shelvin Mack\macksh01,PG,25,UTA,28,27,879,142,320,0.444,35,98,0.357,107,222,0.482,0.498,36,49,0.735,11,95,106,149,26,3,81,65,355
2015,Ian Mahinmi\mahinia01,C,29,IND,71,71,1816,264,448,0.589,0,0,,264,448,0.589,0.589,132,225,0.587,138,369,507,104,65,75,100,220,660
2015,Devyn Marble\marblde01,SG,23,ORL,28,0,249,21,71,0.296,8,32,0.25,13,39,0.333,0.352,10,24,0.417,6,32,38,12,13,1,7,25,60
2015,Boban Marjanović\marjabo01,C,27,SAS,54,4,508,105,174,0.603,0,0,,105,174,0.603,0.603,87,114,0.763,73,121,194,21,12,23,29,54,297
2015,Kendall Marshall\marshke01,PG,24,PHI,30,6,400,43,118,0.364,16,49,0.327,27,69,0.391,0.432,9,13,0.692,2,26,28,73,16,2,43,30,111
2015,Jarell Martin\martija01,PF,21,MEM,27,0,380,54,116,0.466,0,2,0,54,114,0.474,0.466,45,62,0.726,39,47,86,15,8,7,19,58,153
2015,Kevin Martin\martike02,SG,32,TOT,55,13,1095,156,419,0.372,49,136,0.36,107,283,0.378,0.431,153,172,0.89,14,96,110,58,26,3,54,83,514
2015,Kevin Martin\martike02,SG,32,MIN,39,12,834,126,334,0.377,38,103,0.369,88,231,0.381,0.434,125,142,0.88,10,71,81,46,17,1,41,68,415
2015,Kevin Martin\martike02,SG,32,SAS,16,1,261,30,85,0.353,11,33,0.333,19,52,0.365,0.418,28,30,0.933,4,25,29,12,9,2,13,15,99
2015,Wesley Matthews\matthwe02,SF,29,DAL,78,78,2644,331,854,0.388,189,525,0.36,142,329,0.432,0.498,126,146,0.863,27,211,238,151,78,17,78,179,977
2015,O.J. Mayo\mayooj01,SG,28,MIL,41,24,1090,119,321,0.371,52,162,0.321,67,159,0.421,0.452,31,40,0.775,13,92,105,118,48,8,72,126,321
2015,Luc Mbah a Moute\mbahalu01,PF,29,LAC,75,61,1274,94,207,0.454,13,40,0.325,81,167,0.485,0.486,30,57,0.526,60,111,171,30,44,19,34,100,231
2015,James Michael McAdoo\mcadoja01,PF,23,GSW,41,1,262,45,84,0.536,1,2,0.5,44,82,0.537,0.542,26,49,0.531,30,28,58,17,10,8,16,39,117
2015,Ray McCallum\mccalra01,PG,24,TOT,41,6,475,55,146,0.377,15,42,0.357,40,104,0.385,0.428,12,15,0.8,8,39,47,60,12,7,24,29,137
2015,Ray McCallum\mccalra01,PG,24,SAS,31,3,256,27,67,0.403,5,16,0.313,22,51,0.431,0.44,9,10,0.9,6,25,31,33,5,4,11,14,68
2015,Ray McCallum\mccalra01,PG,24,MEM,10,3,219,28,79,0.354,10,26,0.385,18,53,0.34,0.418,3,5,0.6,2,14,16,27,7,3,13,15,69
2015,CJ McCollum\mccolcj01,SG,24,POR,80,80,2780,641,1431,0.448,197,472,0.417,444,959,0.463,0.517,187,226,0.827,47,212,259,341,97,23,196,187,1666
2015,T.J. McConnell\mccontj01,PG,23,PHI,81,17,1606,218,464,0.47,31,89,0.348,187,375,0.499,0.503,26,41,0.634,43,207,250,367,95,10,140,114,493
2015,Chris McCullough\mcculch01,PF,20,BRK,24,4,362,44,109,0.404,13,34,0.382,31,75,0.413,0.463,11,23,0.478,25,43,68,9,28,12,15,39,112
2015,K.J. McDaniels\mcdankj01,SF,22,HOU,37,1,235,29,72,0.403,7,25,0.28,22,47,0.468,0.451,24,30,0.8,16,26,42,10,7,6,17,30,89
2015,Doug McDermott\mcderdo01,SF,24,CHI,81,4,1861,291,644,0.452,110,259,0.425,181,385,0.47,0.537,72,84,0.857,37,158,195,59,14,6,53,127,764
2015,Mitch McGary\mcgarmi01,PF,23,OKC,20,0,72,11,23,0.478,0,4,0,11,19,0.579,0.478,4,10,0.4,4,14,18,3,1,2,7,10,26
2015,JaVale McGee\mcgeeja01,C,28,DAL,34,2,370,77,134,0.575,0,1,0,77,133,0.579,0.575,18,36,0.5,53,80,133,3,5,26,21,49,172
2015,Ben McLemore\mclembe01,SG,22,SAC,68,53,1443,195,455,0.429,67,185,0.362,128,270,0.474,0.502,74,103,0.718,34,114,148,79,52,10,99,140,531
2015,Jordan McRae\mcraejo01,PG,24,TOT,22,1,195,34,78,0.436,10,22,0.455,24,56,0.429,0.5,21,28,0.75,4,16,20,25,3,1,15,17,99
2015,Jordan McRae\mcraejo01,PG,24,PHO,7,0,82,11,26,0.423,3,11,0.273,8,15,0.533,0.481,12,15,0.8,2,6,8,10,3,0,6,7,37
2015,Jordan McRae\mcraejo01,PG,24,CLE,15,1,113,23,52,0.442,7,11,0.636,16,41,0.39,0.51,9,13,0.692,2,10,12,15,0,1,9,10,62
2015,Josh McRoberts\mcrobjo01,PF,28,MIA,42,1,595,55,148,0.372,12,49,0.245,43,99,0.434,0.412,28,40,0.7,22,83,105,81,18,7,30,68,150
2015,Jodie Meeks\meeksjo01,SG,28,DET,3,0,43,7,20,0.35,4,9,0.444,3,11,0.273,0.45,4,4,1,1,4,5,3,0,0,1,2,22
2015,Salah Mejri\mejrisa01,C,29,DAL,34,6,397,49,78,0.628,0,1,0,49,77,0.636,0.628,27,46,0.587,41,82,123,10,8,36,23,54,125
2015,Jordan Mickey\mickejo01,PF,21,BOS,16,0,57,8,22,0.364,0,0,,8,22,0.364,0.364,5,10,0.5,6,7,13,1,0,11,1,5,21
2015,Khris Middleton\middlkh01,SG,24,MIL,79,79,2852,507,1142,0.444,143,361,0.396,364,781,0.466,0.507,277,312,0.888,44,258,302,331,131,19,180,204,1434
2015,C.J. Miles\milescj01,SF,28,IND,64,24,1464,259,634,0.409,142,387,0.367,117,247,0.474,0.521,93,124,0.75,25,150,175,63,53,29,70,142,753
2015,Andre Miller\millean02,PG,39,TOT,39,4,461,59,106,0.557,2,8,0.25,57,98,0.582,0.566,24,32,0.75,12,39,51,87,16,0,37,46,144
2015,Andre Miller\millean02,PG,39,MIN,26,0,280,36,58,0.621,1,4,0.25,35,54,0.648,0.629,15,19,0.789,6,18,24,58,9,0,25,32,88
2015,Andre Miller\millean02,PG,39,SAS,13,4,181,23,48,0.479,1,4,0.25,22,44,0.5,0.49,9,13,0.692,6,21,27,29,7,0,12,14,56
2015,Mike Miller\millemi01,SF,35,DEN,47,2,373,22,62,0.355,19,52,0.365,3,10,0.3,0.508,0,0,,6,47,53,40,13,4,17,53,63
2015,Patty Mills\millspa02,PG,27,SAS,81,3,1662,260,612,0.425,123,320,0.384,137,292,0.469,0.525,47,58,0.81,27,131,158,226,59,6,76,102,690
2015,Elijah Millsap\millsel01,SG,28,UTA,20,0,173,11,39,0.282,1,12,0.083,10,27,0.37,0.295,13,18,0.722,6,29,35,19,7,3,9,33,36
2015,Paul Millsap\millspa01,PF,30,ATL,81,81,2647,501,1066,0.47,74,232,0.319,427,834,0.512,0.505,309,408,0.757,198,534,732,265,147,139,191,237,1385
2015,Nikola Mirotić\mirotni01,PF,24,CHI,66,38,1646,248,609,0.407,135,346,0.39,113,263,0.43,0.518,146,181,0.807,58,304,362,100,58,46,102,151,777
2015,Nazr Mohammed\mohamna01,C,38,OKC,5,0,19,3,5,0.6,0,0,,3,5,0.6,0.6,2,2,1,1,3,4,0,0,0,3,4,8
2015,Greg Monroe\monrogr01,C,25,MIL,79,67,2314,491,941,0.522,0,1,0,491,940,0.522,0.522,228,308,0.74,218,478,696,178,72,67,129,163,1210
2015,Luis Montero\montelu01,SG,22,POR,12,0,42,5,19,0.263,1,9,0.111,4,10,0.4,0.289,3,4,0.75,0,4,4,1,0,0,4,1,14
2015,E'Twaun Moore\mooreet01,SG,26,CHI,59,22,1263,187,389,0.481,47,104,0.452,140,285,0.491,0.541,22,35,0.629,19,114,133,99,37,18,53,103,443
2015,Eric Moreland\moreler01,PF,24,SAC,8,0,48,3,6,0.5,0,0,,3,6,0.5,0.5,2,4,0.5,3,8,11,1,0,4,3,4,8
2015,Marcus Morris\morrima03,SF,26,DET,80,80,2856,410,945,0.434,108,298,0.362,302,647,0.467,0.491,203,271,0.749,91,313,404,201,67,23,140,170,1131
2015,Markieff Morris\morrima02,PF,26,TOT,64,45,1629,305,718,0.425,47,155,0.303,258,563,0.458,0.458,108,147,0.735,73,279,352,124,58,34,135,184,765
2015,Markieff Morris\morrima02,PF,26,PHO,37,24,917,171,431,0.397,22,76,0.289,149,355,0.42,0.422,66,92,0.717,43,151,194,87,33,17,90,104,430
2015,Markieff Morris\morrima02,PF,26,WAS,27,21,712,134,287,0.467,25,79,0.316,109,208,0.524,0.51,42,55,0.764,30,128,158,37,25,17,45,80,335
2015,Anthony Morrow\morroan01,SG,30,OKC,68,6,926,136,333,0.408,79,204,0.387,57,129,0.442,0.527,29,39,0.744,10,52,62,24,22,5,17,64,380
2015,Donatas Motiejūnas\motiedo01,PF,25,HOU,37,22,547,90,205,0.439,16,57,0.281,74,148,0.5,0.478,34,53,0.642,37,72,109,41,17,5,44,69,230
2015,Timofey Mozgov\mozgoti01,C,29,CLE,76,48,1326,203,359,0.565,1,7,0.143,202,352,0.574,0.567,68,95,0.716,110,227,337,33,22,57,71,159,475
2015,Emmanuel Mudiay\mudiaem01,PG,19,DEN,68,66,2068,329,905,0.364,74,232,0.319,255,673,0.379,0.404,140,209,0.67,32,200,232,372,65,35,217,141,872
2015,Shabazz Muhammad\muhamsh01,SF,23,MIN,82,0,1682,317,681,0.465,44,152,0.289,273,529,0.516,0.498,185,242,0.764,100,167,267,52,24,7,70,94,863
2015,Xavier Munford\munfoxa02,SG,23,MEM,14,0,244,32,77,0.416,9,23,0.391,23,54,0.426,0.474,7,14,0.5,3,28,31,22,13,3,15,25,80
2015,Mike Muscala\muscami01,C,24,ATL,60,0,565,76,152,0.5,12,39,0.308,64,113,0.566,0.539,31,39,0.795,38,79,117,34,13,27,27,72,195
2015,Larry Nance Jr.\nancela02,PF,23,LAL,63,22,1266,158,300,0.527,1,10,0.1,157,290,0.541,0.528,32,47,0.681,101,211,312,44,54,23,41,124,349
2015,Shabazz Napier\napiesh01,PG,24,ORL,55,0,600,68,201,0.338,34,104,0.327,34,97,0.351,0.423,33,45,0.733,9,46,55,97,23,1,46,38,203
2015,Gary Neal\nealga01,SG,31,WAS,40,2,807,151,325,0.465,41,100,0.41,110,225,0.489,0.528,47,55,0.855,11,72,83,47,20,1,29,55,390
2015,Jameer Nelson\nelsoja01,PG,33,DEN,39,15,1036,113,307,0.368,43,144,0.299,70,163,0.429,0.438,30,35,0.857,19,96,115,190,25,5,66,100,299
2015,Raul Neto\netora01,PG,23,UTA,81,53,1499,180,418,0.431,64,162,0.395,116,256,0.453,0.507,52,70,0.743,17,103,120,174,62,2,109,122,476
2015,Andrew Nicholson\nichoan01,PF,26,ORL,56,0,823,146,310,0.471,41,114,0.36,105,196,0.536,0.537,51,65,0.785,34,167,201,25,10,22,41,69,384
2015,Joakim Noah\noahjo01,C,30,CHI,29,2,635,51,133,0.383,0,1,0,51,132,0.386,0.383,22,45,0.489,87,168,255,110,18,29,52,77,124
2015,Nerlens Noel\noelne01,C,21,PHI,67,62,1965,306,587,0.521,1,2,0.5,305,585,0.521,0.522,134,227,0.59,154,388,542,122,118,100,158,192,747
2015,Lucas Nogueira\noguelu01,C,23,TOR,29,1,225,28,44,0.636,1,3,0.333,27,41,0.659,0.648,8,15,0.533,18,28,46,7,12,12,11,29,65
2015,Steve Novak\novakst01,PF,32,TOT,10,0,44,8,18,0.444,7,15,0.467,1,3,0.333,0.639,1,1,1,0,5,5,0,0,0,1,3,24
2015,Steve Novak\novakst01,PF,32,OKC,7,0,24,6,12,0.5,5,9,0.556,1,3,0.333,0.708,0,0,,0,4,4,0,0,0,1,1,17
2015,Steve Novak\novakst01,PF,32,MIL,3,0,20,2,6,0.333,2,6,0.333,0,0,,0.5,1,1,1,0,1,1,0,0,0,0,2,7
2015,Dirk Nowitzki\nowitdi01,PF,37,DAL,75,75,2364,498,1112,0.448,126,342,0.368,372,770,0.483,0.504,250,280,0.893,52,437,489,132,52,52,84,161,1372
2015,Jusuf Nurkić\nurkiju01,C,21,DEN,32,3,547,101,242,0.417,0,3,0,101,239,0.423,0.417,61,99,0.616,65,110,175,40,24,44,55,91,263
2015,J.J. O'Brien\obriejj01,SF,23,UTA,2,0,6,0,1,0,0,0,,0,1,0,0,0,0,,0,1,1,0,1,0,0,1,0
2015,Johnny O'Bryant\obryajo01,PF,22,MIL,66,4,857,86,209,0.411,1,1,1,85,208,0.409,0.414,27,40,0.675,65,111,176,32,18,8,31,100,200
2015,Kyle O'Quinn\oquinky01,PF,25,NYK,65,1,764,129,271,0.476,5,22,0.227,124,249,0.498,0.485,46,60,0.767,76,174,250,72,20,49,61,107,309
2015,Jahlil Okafor\okafoja01,C,20,PHI,53,48,1591,397,781,0.508,1,6,0.167,396,775,0.511,0.509,133,194,0.686,122,251,373,65,22,61,124,140,928
2015,Victor Oladipo\oladivi01,SG,23,ORL,72,52,2379,425,970,0.438,98,282,0.348,327,688,0.475,0.489,205,247,0.83,48,297,345,282,116,54,153,174,1153
2015,Kelly Olynyk\olynyke01,C,24,BOS,69,8,1395,253,556,0.455,85,210,0.405,168,346,0.486,0.531,96,128,0.75,72,209,281,105,52,33,74,163,687
2015,Kelly Oubre Jr.\oubreke01,SF,20,WAS,63,9,671,90,211,0.427,25,79,0.316,65,132,0.492,0.486,31,49,0.633,25,108,133,13,22,7,34,100,236
2015,Zaza Pachulia\pachuza01,C,31,DAL,76,69,2004,219,470,0.466,0,3,0,219,467,0.469,0.466,212,276,0.768,249,469,718,128,64,22,119,181,650
2015,Kostas Papanikolaou\papanko01,SF,25,DEN,26,6,294,24,66,0.364,10,32,0.313,14,34,0.412,0.439,9,14,0.643,8,32,40,16,13,5,21,24,67
2015,Jabari Parker\parkeja01,PF,20,MIL,76,72,2408,443,899,0.493,9,35,0.257,434,864,0.502,0.498,175,228,0.768,123,272,395,130,69,29,116,154,1070
2015,Tony Parker\parketo01,PG,33,SAS,72,72,1980,350,710,0.493,27,65,0.415,323,645,0.501,0.512,130,171,0.76,17,159,176,379,54,11,131,114,857
2015,Chandler Parsons\parsoch01,SF,27,DAL,61,51,1799,320,651,0.492,104,251,0.414,216,400,0.54,0.571,93,136,0.684,29,256,285,169,46,21,95,114,837
2015,Lamar Patterson\pattela01,SG,24,ATL,35,0,395,28,80,0.35,12,49,0.245,16,31,0.516,0.425,16,22,0.727,4,46,50,39,9,2,23,45,84
2015,Patrick Patterson\pattepa01,PF,26,TOR,79,0,2020,204,493,0.414,106,293,0.362,98,200,0.49,0.521,29,34,0.853,77,265,342,94,53,32,65,128,543
2015,Chris Paul\paulch01,PG,30,LAC,74,74,2420,515,1114,0.462,122,329,0.371,393,785,0.501,0.517,294,328,0.896,39,271,310,738,152,13,194,185,1446
2015,Adreian Payne\paynead01,PF,24,MIN,52,2,486,53,145,0.366,9,32,0.281,44,113,0.389,0.397,17,26,0.654,20,91,111,29,16,11,36,77,132
2015,Cameron Payne\payneca01,PG,21,OKC,57,1,698,114,278,0.41,36,111,0.324,78,167,0.467,0.475,19,24,0.792,9,76,85,108,36,6,44,80,283
2015,Elfrid Payton\paytoel01,PG,21,ORL,73,69,2145,318,730,0.436,30,92,0.326,288,638,0.451,0.456,112,190,0.589,77,184,261,468,89,20,177,159,778
2015,Nikola Peković\pekovni01,C,30,MIN,12,3,156,19,50,0.38,0,0,,19,50,0.38,0.38,16,20,0.8,7,14,21,11,1,0,9,22,54
2015,Kendrick Perkins\perkike01,C,31,NOP,37,5,542,40,75,0.533,0,0,,40,75,0.533,0.533,11,25,0.44,25,103,128,31,11,11,41,64,91
2015,Paul Pierce\piercpa01,SF,38,LAC,68,38,1231,144,397,0.363,75,242,0.31,69,155,0.445,0.457,54,66,0.818,12,174,186,71,33,17,58,129,417
2015,Tibor Pleiß\pleisti01,C,26,UTA,12,0,82,11,25,0.44,0,2,0,11,23,0.478,0.44,2,2,1,6,9,15,2,1,2,8,19,24
2015,Mason Plumlee\plumlma01,C,25,POR,82,82,2084,267,517,0.516,0,4,0,267,513,0.52,0.516,215,335,0.642,201,427,628,226,68,85,154,253,749
2015,Miles Plumlee\plumlmi01,C,27,MIL,61,14,870,140,233,0.601,0,0,,140,233,0.601,0.601,34,59,0.576,94,138,232,16,21,50,40,73,314
2015,Otto Porter\porteot01,SF,22,WAS,75,73,2276,339,717,0.473,98,267,0.367,241,450,0.536,0.541,95,126,0.754,97,294,391,120,105,32,70,163,871
2015,Bobby Portis\portibo01,PF,20,CHI,62,4,1102,186,436,0.427,16,52,0.308,170,384,0.443,0.445,48,66,0.727,123,214,337,52,25,22,54,100,436
2015,Kristaps Porziņģis\porzikr01,PF,20,NYK,72,72,2047,373,886,0.421,81,243,0.333,292,643,0.454,0.467,201,240,0.838,132,394,526,94,53,134,121,205,1028
2015,Dwight Powell\poweldw01,PF,24,DAL,69,2,992,146,296,0.493,2,16,0.125,144,280,0.514,0.497,105,142,0.739,84,189,273,44,36,24,40,118,399
2015,Norman Powell\powelno01,SG,22,TOR,49,24,725,97,229,0.424,36,89,0.404,61,140,0.436,0.502,43,53,0.811,16,95,111,47,29,10,32,59,273
2015,Phil Pressey\pressph01,PG,24,TOT,23,0,283,30,78,0.385,4,18,0.222,26,60,0.433,0.41,13,25,0.52,3,28,31,75,18,4,33,28,77
2015,Phil Pressey\pressph01,PG,24,PHI,14,0,170,21,55,0.382,4,13,0.308,17,42,0.405,0.418,9,18,0.5,0,23,23,46,11,1,19,14,55
2015,Phil Pressey\pressph01,PG,24,PHO,9,0,113,9,23,0.391,0,5,0,9,18,0.5,0.391,4,7,0.571,3,5,8,29,7,3,14,14,22
2015,Ronnie Price\pricero01,PG,32,PHO,62,18,1211,116,302,0.384,68,196,0.347,48,106,0.453,0.497,31,41,0.756,25,74,99,147,74,13,70,161,331
2015,Pablo Prigioni\prigipa01,PG,38,LAC,59,3,823,55,147,0.374,28,95,0.295,27,52,0.519,0.469,7,8,0.875,38,76,114,130,53,1,49,82,145
2015,Tayshaun Prince\princta01,SF,35,MIN,77,44,1462,102,229,0.445,4,23,0.174,98,206,0.476,0.454,13,19,0.684,32,115,147,73,36,13,27,62,221
2015,Julius Randle\randlju01,PF,21,LAL,81,60,2286,358,835,0.429,10,36,0.278,348,799,0.436,0.435,193,270,0.715,172,657,829,144,53,29,149,242,919
2015,Zach Randolph\randoza01,PF,34,MEM,68,53,2016,431,907,0.475,6,26,0.231,425,881,0.482,0.479,172,216,0.796,179,350,529,142,43,13,105,146,1040
2015,J.J. Redick\redicjj01,SG,31,LAC,75,75,2097,422,880,0.48,200,421,0.475,222,459,0.484,0.593,182,205,0.888,10,129,139,106,42,5,78,135,1226
2015,Willie Reed\reedwi02,C,25,BRK,39,2,426,76,133,0.571,0,0,,76,133,0.571,0.571,30,55,0.545,49,73,122,10,6,30,16,47,182
2015,Josh Richardson\richajo01,SG,22,MIA,52,2,1107,123,272,0.452,53,115,0.461,70,157,0.446,0.55,42,63,0.667,21,86,107,73,36,25,35,107,341
2015,Austin Rivers\riverau01,SG,23,LAC,67,7,1464,226,516,0.438,62,185,0.335,164,331,0.495,0.498,79,116,0.681,22,108,130,99,48,9,61,137,593
2015,Andre Roberson\roberan03,SG,24,OKC,70,70,1553,136,274,0.496,32,103,0.311,104,171,0.608,0.555,33,54,0.611,79,172,251,47,53,42,35,133,337
2015,Brian Roberts\roberbr01,PG,30,TOT,51,0,470,74,165,0.448,15,42,0.357,59,123,0.48,0.494,42,47,0.894,6,35,41,54,10,2,23,35,205
2015,Brian Roberts\roberbr01,PG,30,CHO,30,0,333,51,115,0.443,9,27,0.333,42,88,0.477,0.483,34,37,0.919,4,25,29,38,7,1,16,23,145
2015,Brian Roberts\roberbr01,PG,30,POR,21,0,137,23,50,0.46,6,15,0.4,17,35,0.486,0.52,8,10,0.8,2,10,12,16,3,1,7,12,60
2015,Glenn Robinson III\robingl02,SF,22,IND,45,4,508,65,151,0.43,14,37,0.378,51,114,0.447,0.477,27,39,0.692,12,56,68,26,17,9,18,21,171
2015,Nate Robinson\robinna01,PG,31,NOP,2,1,23,0,1,0,0,1,0,0,0,,0,0,0,,0,0,0,4,1,0,0,5,0
2015,Thomas Robinson\robinth01,PF,24,BRK,71,7,917,130,291,0.447,0,1,0,130,290,0.448,0.447,47,109,0.431,136,223,359,46,39,36,69,111,307
2015,Rajon Rondo\rondora01,PG,29,SAC,72,72,2537,355,782,0.454,62,170,0.365,293,612,0.479,0.494,87,150,0.58,77,358,435,839,141,10,278,175,859
2015,Derrick Rose\rosede01,PG,27,CHI,66,66,2097,447,1048,0.427,44,150,0.293,403,898,0.449,0.448,142,179,0.793,46,179,225,311,44,14,175,84,1080
2015,Terrence Ross\rosste01,SF,24,TOR,73,7,1747,270,626,0.431,131,339,0.386,139,287,0.484,0.536,49,62,0.79,21,164,185,56,54,25,46,120,720
2015,Terry Rozier\roziete01,PG,21,BOS,39,0,311,29,106,0.274,6,27,0.222,23,79,0.291,0.302,8,10,0.8,24,39,63,37,6,1,19,23,72
2015,Ricky Rubio\rubiori01,PG,25,MIN,76,76,2323,219,586,0.374,62,190,0.326,157,396,0.396,0.427,266,314,0.847,40,286,326,658,162,10,193,201,766
2015,Damjan Rudež\rudezda01,SF,29,MIN,33,0,277,25,62,0.403,17,50,0.34,8,12,0.667,0.54,8,8,1,5,15,20,11,3,1,13,33,75
2015,Brandon Rush\rushbr01,SG,30,GSW,72,25,1055,111,260,0.427,65,157,0.414,46,103,0.447,0.552,18,28,0.643,21,160,181,57,20,23,33,57,305
2015,D'Angelo Russell\russeda01,PG,19,LAL,80,48,2259,392,956,0.41,130,370,0.351,262,586,0.447,0.478,140,190,0.737,47,227,274,266,93,13,196,142,1054
2015,Robert Sacre\sacrero01,C,26,LAL,25,1,320,31,75,0.413,0,0,,31,75,0.413,0.413,25,38,0.658,32,40,72,14,4,10,12,43,87
2015,JaKarr Sampson\sampsja02,SF,22,TOT,73,40,1160,140,317,0.442,14,63,0.222,126,254,0.496,0.464,80,122,0.656,46,144,190,46,23,33,70,142,374
2015,JaKarr Sampson\sampsja02,SF,22,PHI,47,18,691,86,202,0.426,6,34,0.176,80,168,0.476,0.441,62,97,0.639,30,99,129,30,11,16,51,91,240
2015,JaKarr Sampson\sampsja02,SF,22,DEN,26,22,469,54,115,0.47,8,29,0.276,46,86,0.535,0.504,18,25,0.72,16,45,61,16,12,17,19,51,134
2015,Dennis Schröder\schrode01,PG,22,ATL,80,6,1621,329,781,0.421,77,239,0.322,252,542,0.465,0.471,144,182,0.791,25,179,204,349,70,9,183,138,879
2015,Luis Scola\scolalu01,PF,35,TOR,76,76,1636,269,598,0.45,65,161,0.404,204,437,0.467,0.504,61,84,0.726,84,276,360,66,46,27,68,178,664
2015,Mike Scott\scottmi01,PF,27,ATL,75,0,1146,176,376,0.468,62,158,0.392,114,218,0.523,0.551,50,63,0.794,53,153,206,78,25,17,42,102,464
2015,Thabo Sefolosha\sefolth01,SF,31,ATL,75,11,1758,188,372,0.505,42,124,0.339,146,248,0.589,0.562,62,99,0.626,52,282,334,107,85,37,68,109,480
2015,Kevin Séraphin\serapke01,C,26,NYK,48,0,526,84,205,0.41,0,2,0,84,203,0.414,0.41,19,23,0.826,31,95,126,47,8,36,43,67,187
2015,Ramon Sessions\sessira01,PG,29,WAS,82,5,1667,280,592,0.473,36,111,0.324,244,481,0.507,0.503,214,283,0.756,25,178,203,239,46,5,115,102,810
2015,Iman Shumpert\shumpim01,SG,25,CLE,54,5,1316,114,305,0.374,43,146,0.295,71,159,0.447,0.444,40,51,0.784,32,171,203,92,54,19,57,119,311
2015,Jonathon Simmons\simmojo02,SG,26,SAS,55,2,813,122,242,0.504,18,47,0.383,104,195,0.533,0.541,69,92,0.75,16,80,96,58,24,5,53,103,331
2015,Henry Sims\simshe01,C,25,BRK,14,4,263,33,77,0.429,0,0,,33,77,0.429,0.429,25,30,0.833,21,51,72,9,9,14,12,37,91
2015,Kyle Singler\singlky01,SF,27,OKC,68,2,977,86,221,0.389,30,97,0.309,56,124,0.452,0.457,29,44,0.659,50,91,141,24,30,9,32,120,231
2015,Donald Sloan\sloando01,PG,28,BRK,61,33,1318,154,350,0.44,38,99,0.384,116,251,0.462,0.494,78,104,0.75,17,156,173,268,32,4,80,73,424
2015,Marcus Smart\smartma01,PG,21,BOS,61,10,1667,184,529,0.348,61,241,0.253,123,288,0.427,0.405,129,166,0.777,76,179,255,185,91,18,80,183,558
2015,Greg Smith\smithgr02,PF,25,MIN,18,0,192,18,32,0.563,0,0,,18,32,0.563,0.563,7,17,0.412,12,30,42,6,4,1,7,28,43
2015,Ish Smith\smithis01,PG,27,TOT,77,53,2239,397,967,0.411,56,170,0.329,341,797,0.428,0.44,122,176,0.693,43,262,305,502,88,24,175,133,972
2015,Ish Smith\smithis01,PG,27,NOP,27,3,617,98,228,0.43,10,33,0.303,88,195,0.451,0.452,33,43,0.767,14,78,92,154,24,6,45,38,239
2015,Ish Smith\smithis01,PG,27,PHI,50,50,1622,299,739,0.405,46,137,0.336,253,602,0.42,0.436,89,133,0.669,29,184,213,348,64,18,130,95,733
2015,J.R. Smith\smithjr01,SG,30,CLE,77,77,2362,353,850,0.415,204,510,0.4,149,340,0.438,0.535,45,71,0.634,43,174,217,130,81,21,59,204,955
2015,Jason Smith\smithja02,C,29,ORL,76,2,1181,244,503,0.485,4,16,0.25,240,487,0.493,0.489,54,67,0.806,53,166,219,62,33,65,57,163,546
2015,Josh Smith\smithjo03,PF,30,TOT,55,7,880,127,349,0.364,41,143,0.287,86,206,0.417,0.423,37,67,0.552,51,141,192,90,34,47,77,118,332
2015,Josh Smith\smithjo03,PF,30,LAC,32,1,459,69,180,0.383,18,58,0.31,51,122,0.418,0.433,25,42,0.595,33,92,125,42,18,34,41,62,181
2015,Josh Smith\smithjo03,PF,30,HOU,23,6,421,58,169,0.343,23,85,0.271,35,84,0.417,0.411,12,25,0.48,18,49,67,48,16,13,36,56,151
2015,Russ Smith\smithru01,PG,24,MEM,15,0,66,7,22,0.318,1,5,0.2,6,17,0.353,0.341,8,13,0.615,1,8,9,11,5,1,7,5,23
2015,Tony Snell\snellto01,SF,24,CHI,64,33,1301,126,339,0.372,56,155,0.361,70,184,0.38,0.454,30,33,0.909,19,180,199,63,16,17,52,100,338
2015,Marreese Speights\speigma01,C,28,GSW,72,0,832,197,456,0.432,24,62,0.387,173,394,0.439,0.458,94,114,0.825,77,162,239,61,19,34,66,117,512
2015,Tiago Splitter\splitti01,C,31,ATL,36,2,579,81,155,0.523,0,2,0,81,153,0.529,0.523,39,48,0.813,45,75,120,30,20,12,24,71,201
2015,Nik Stauskas\stausni01,SG,22,PHI,73,35,1809,210,545,0.385,106,325,0.326,104,220,0.473,0.483,91,118,0.771,23,160,183,138,44,20,94,115,617
2015,Lance Stephenson\stephla01,SF,25,TOT,69,13,1372,228,474,0.481,30,78,0.385,198,396,0.5,0.513,87,111,0.784,40,183,223,133,43,9,94,135,573
2015,Lance Stephenson\stephla01,SF,25,LAC,43,10,680,82,166,0.494,19,47,0.404,63,119,0.529,0.551,21,30,0.7,19,89,108,60,24,3,48,79,204
2015,Lance Stephenson\stephla01,SF,25,MEM,26,3,692,146,308,0.474,11,31,0.355,135,277,0.487,0.492,66,81,0.815,21,94,115,73,19,6,46,56,369
2015,Alex Stepheson\stephal01,PF,28,TOT,8,0,73,9,27,0.333,0,0,,9,27,0.333,0.333,4,12,0.333,19,9,28,2,1,5,0,12,22
2015,Alex Stepheson\stephal01,PF,28,LAC,4,0,12,1,1,1,0,0,,1,1,1,1,0,2,0,1,1,2,0,0,2,0,4,2
2015,Alex Stepheson\stephal01,PF,28,MEM,4,0,61,8,26,0.308,0,0,,8,26,0.308,0.308,4,10,0.4,18,8,26,2,1,3,0,8,20
2015,Jarnell Stokes\stokeja01,C,22,TOT,7,0,18,3,5,0.6,0,0,,3,5,0.6,0.6,1,2,0.5,1,3,4,1,1,0,0,1,7
2015,Jarnell Stokes\stokeja01,C,22,MEM,2,0,4,0,0,,0,0,,0,0,,,0,0,,1,1,2,0,0,0,0,0,0
2015,Jarnell Stokes\stokeja01,C,22,MIA,5,0,14,3,5,0.6,0,0,,3,5,0.6,0.6,1,2,0.5,0,2,2,1,1,0,0,1,7
2015,Amar'e Stoudemire\stoudam01,C,33,MIA,52,36,762,125,221,0.566,0,0,,125,221,0.566,0.566,50,67,0.746,65,157,222,27,18,41,47,92,300
2015,Rodney Stuckey\stuckro01,PG,29,IND,58,1,1275,183,443,0.413,20,83,0.241,163,360,0.453,0.436,131,158,0.829,19,137,156,142,43,8,76,77,517
2015,Jared Sullinger\sullija01,PF,23,BOS,81,73,1915,351,806,0.435,29,103,0.282,322,703,0.458,0.453,103,161,0.64,194,479,673,187,75,47,102,209,834
2015,Edy Tavares\tavarwa01,C,23,ATL,11,0,73,11,19,0.579,0,0,,11,19,0.579,0.579,3,8,0.375,7,14,21,3,1,6,5,8,25
2015,Jeff Teague\teaguje01,PG,27,ATL,79,78,2255,434,988,0.439,110,275,0.4,324,713,0.454,0.495,261,312,0.837,33,181,214,470,97,24,218,167,1239
2015,Mirza Teletović\teletmi01,PF,30,PHO,79,1,1686,332,777,0.427,181,460,0.393,151,317,0.476,0.544,120,155,0.774,55,247,302,89,32,21,84,159,965
2015,Garrett Temple\templga01,SF,29,WAS,80,43,1951,201,505,0.398,89,258,0.345,112,247,0.453,0.486,91,125,0.728,36,176,212,140,69,18,64,195,582
2015,Jason Terry\terryja01,SG,38,HOU,72,7,1258,151,376,0.402,93,261,0.356,58,115,0.504,0.525,27,33,0.818,14,65,79,103,47,9,49,91,422
2015,Isaiah Thomas\thomais02,PG,26,BOS,82,79,2644,591,1382,0.428,167,465,0.359,424,917,0.462,0.488,474,544,0.871,46,197,243,509,91,9,220,167,1823
2015,Lance Thomas\thomala01,PF,27,NYK,59,5,1313,169,382,0.442,44,109,0.404,125,273,0.458,0.5,102,119,0.857,34,97,131,53,22,7,57,109,484
2015,Hollis Thompson\thompho01,SG,24,PHI,77,17,2154,270,680,0.397,149,392,0.38,121,288,0.42,0.507,69,96,0.719,54,218,272,99,36,24,76,187,758
2015,Jason Thompson\thompja02,C,29,TOT,47,7,471,52,108,0.481,5,15,0.333,47,93,0.505,0.505,38,54,0.704,32,102,134,29,12,20,15,80,147
2015,Jason Thompson\thompja02,C,29,GSW,28,1,179,20,42,0.476,0,0,,20,42,0.476,0.476,20,32,0.625,10,44,54,19,4,8,7,40,60
2015,Jason Thompson\thompja02,C,29,TOR,19,6,292,32,66,0.485,5,15,0.333,27,51,0.529,0.523,18,22,0.818,22,58,80,10,8,12,8,40,87
2015,Klay Thompson\thompkl01,SG,25,GSW,80,80,2666,651,1386,0.47,276,650,0.425,375,736,0.51,0.569,193,221,0.873,35,271,306,166,60,49,138,152,1771
2015,Tristan Thompson\thomptr01,PF,24,CLE,82,34,2269,247,420,0.588,0,0,,247,420,0.588,0.588,149,242,0.616,268,470,738,62,38,51,61,202,643
2015,Marcus Thornton\thornma01,SG,28,TOT,61,8,1109,216,542,0.399,91,270,0.337,125,272,0.46,0.482,67,79,0.848,38,112,150,85,47,4,51,90,590
2015,Marcus Thornton\thornma01,SG,28,HOU,47,6,885,174,435,0.4,73,216,0.338,101,219,0.461,0.484,51,58,0.879,31,84,115,66,34,3,40,73,472
2015,Marcus Thornton\thornma01,SG,28,WAS,14,2,224,42,107,0.393,18,54,0.333,24,53,0.453,0.477,16,21,0.762,7,28,35,19,13,1,11,17,118
2015,Anthony Tolliver\tollian01,PF,30,DET,72,5,1341,128,332,0.386,98,272,0.36,30,60,0.5,0.533,29,47,0.617,39,190,229,52,26,16,28,86,383
2015,Axel Toupane\toupaax01,SF,23,DEN,21,0,305,25,70,0.357,13,40,0.325,12,30,0.4,0.45,13,17,0.765,8,23,31,15,7,6,6,40,76
2015,Karl-Anthony Towns\townska01,C,20,MIN,82,82,2627,625,1153,0.542,30,88,0.341,595,1065,0.559,0.555,223,275,0.811,229,629,858,161,58,138,183,245,1503
2015,P.J. Tucker\tuckepj01,SF,30,PHO,82,80,2540,239,582,0.411,68,206,0.33,171,376,0.455,0.469,106,142,0.746,165,347,512,177,106,20,111,202,652
2015,Evan Turner\turneev01,SG,27,BOS,81,12,2271,343,753,0.456,20,83,0.241,323,670,0.482,0.469,148,179,0.827,50,347,397,359,80,28,169,139,854
2015,Myles Turner\turnemy01,C,19,IND,60,30,1367,264,530,0.498,3,14,0.214,261,516,0.506,0.501,88,121,0.727,68,264,332,41,25,86,67,158,619
2015,Beno Udrih\udrihbe01,PG,33,TOT,44,5,707,86,198,0.434,15,44,0.341,71,154,0.461,0.472,18,20,0.9,8,64,72,116,14,1,53,51,205
2015,Beno Udrih\udrihbe01,PG,33,MEM,8,0,120,20,46,0.435,4,11,0.364,16,35,0.457,0.478,3,3,1,2,7,9,26,3,1,11,11,47
2015,Beno Udrih\udrihbe01,PG,33,MIA,36,5,587,66,152,0.434,11,33,0.333,55,119,0.462,0.47,15,17,0.882,6,57,63,90,11,0,42,40,158
2015,Jonas Valančiūnas\valanjo01,C,23,TOR,60,59,1557,303,536,0.565,0,0,,303,536,0.565,0.565,162,213,0.761,184,363,547,42,25,80,85,158,768
2015,Anderson Varejão\varejan01,C,33,TOT,53,0,496,53,124,0.427,0,1,0,53,123,0.431,0.427,32,50,0.64,37,104,141,35,16,10,22,70,138
2015,Anderson Varejão\varejan01,C,33,CLE,31,0,310,32,76,0.421,0,1,0,32,75,0.427,0.421,16,21,0.762,24,67,91,20,11,5,16,35,80
2015,Anderson Varejão\varejan01,C,33,GSW,22,0,186,21,48,0.438,0,0,,21,48,0.438,0.438,16,29,0.552,13,37,50,15,5,5,6,35,58
2015,Greivis Vásquez\vasqugr01,PG,29,MIL,23,0,460,45,138,0.326,18,73,0.247,27,65,0.415,0.391,22,26,0.846,5,42,47,91,10,0,40,42,130
2015,Rashad Vaughn\vaughra01,SG,19,MIL,70,6,1001,81,266,0.305,43,147,0.293,38,119,0.319,0.385,12,15,0.8,11,77,88,39,29,16,28,73,217
2015,Charlie Villanueva\villach01,PF,31,DAL,62,4,665,125,327,0.382,47,172,0.273,78,155,0.503,0.454,22,24,0.917,24,128,152,24,18,15,31,71,319
2015,Noah Vonleh\vonleno01,PF,20,POR,78,56,1174,117,278,0.421,11,46,0.239,106,232,0.457,0.441,38,51,0.745,91,214,305,30,27,26,50,152,283
2015,Nikola Vučević\vucevni01,C,25,ORL,65,60,2037,533,1046,0.51,2,9,0.222,531,1037,0.512,0.511,113,150,0.753,174,402,576,179,53,70,123,173,1181
2015,Sasha Vujačić\vujacsa01,SG,31,NYK,61,25,908,106,277,0.383,52,143,0.364,54,134,0.403,0.477,32,39,0.821,26,123,149,84,34,5,44,83,296
2015,Dwyane Wade\wadedw01,SG,34,MIA,74,73,2258,540,1183,0.456,7,44,0.159,533,1139,0.468,0.459,322,406,0.793,82,220,302,344,79,42,203,116,1409
2015,Dion Waiters\waitedi01,SG,24,OKC,78,15,2152,282,706,0.399,86,240,0.358,196,466,0.421,0.46,112,157,0.713,36,166,202,154,81,15,120,143,762
2015,Kemba Walker\walkeke02,PG,25,CHO,81,81,2885,568,1331,0.427,182,490,0.371,386,841,0.459,0.495,371,438,0.847,56,301,357,421,126,39,171,111,1689
2015,John Wall\walljo01,PG,25,WAS,77,77,2784,572,1349,0.424,115,328,0.351,457,1021,0.448,0.467,272,344,0.791,42,337,379,789,145,59,318,159,1531
2015,T.J. Warren\warretj01,SF,22,PHO,47,4,1070,221,441,0.501,28,70,0.4,193,371,0.52,0.533,45,64,0.703,57,90,147,44,37,16,32,94,515
2015,C.J. Watson\watsocj01,PG,31,ORL,33,2,656,47,137,0.343,14,48,0.292,33,89,0.371,0.394,34,39,0.872,10,56,66,88,19,5,25,49,142
2015,Briante Weber\weberbr01,PG,23,TOT,7,4,169,14,39,0.359,0,5,0,14,34,0.412,0.359,3,4,0.75,8,17,25,21,9,3,9,12,31
2015,Briante Weber\weberbr01,PG,23,MEM,6,4,166,13,38,0.342,0,5,0,13,33,0.394,0.342,3,4,0.75,8,16,24,20,9,3,9,11,29
2015,Briante Weber\weberbr01,PG,23,MIA,1,0,3,1,1,1,0,0,,1,1,1,1,0,0,,0,1,1,1,0,0,0,1,2
2015,Sonny Weems\weemsso01,SG-SF,29,TOT,43,0,499,42,110,0.382,15,41,0.366,27,69,0.391,0.45,8,15,0.533,7,46,53,49,10,1,41,47,107
2015,Sonny Weems\weemsso01,SG,29,PHO,36,0,421,35,89,0.393,13,32,0.406,22,57,0.386,0.466,7,13,0.538,6,35,41,47,10,1,37,40,90
2015,Sonny Weems\weemsso01,SF,29,PHI,7,0,78,7,21,0.333,2,9,0.222,5,12,0.417,0.381,1,2,0.5,1,11,12,2,0,0,4,7,17
2015,David West\westda01,PF,35,SAS,78,19,1404,244,448,0.545,3,7,0.429,241,441,0.546,0.548,63,80,0.788,72,237,309,143,44,55,68,142,554
2015,Russell Westbrook\westbru01,PG,27,OKC,80,80,2750,656,1444,0.454,101,341,0.296,555,1103,0.503,0.489,465,573,0.812,145,481,626,834,163,20,342,200,1878
2015,Hassan Whiteside\whiteha01,C,26,MIA,73,43,2125,413,682,0.606,0,0,,413,682,0.606,0.606,214,329,0.65,238,627,865,30,44,269,137,201,1040
2015,Shayne Whittington\whittsh01,PF,24,IND,7,0,41,5,11,0.455,0,2,0,5,9,0.556,0.455,1,2,0.5,5,7,12,3,1,1,5,7,11
2015,Andrew Wiggins\wiggian01,SF,20,MIN,81,81,2845,594,1294,0.459,57,190,0.3,537,1104,0.486,0.481,430,565,0.761,105,186,291,164,78,46,182,165,1675
2015,C.J. Wilcox\wilcocj01,SG,25,LAC,23,0,167,26,66,0.394,9,23,0.391,17,43,0.395,0.462,9,12,0.75,1,11,12,10,10,2,2,15,70
2015,Alan Williams\willial03,PF,23,PHO,10,0,68,10,24,0.417,0,0,,10,24,0.417,0.417,9,14,0.643,14,24,38,5,4,5,6,15,29
2015,Deron Williams\willide01,PG,31,DAL,65,63,2106,321,775,0.414,97,282,0.344,224,493,0.454,0.477,179,206,0.869,19,171,190,378,61,14,150,155,918
2015,Derrick Williams\willide02,SF,24,NYK,80,9,1435,254,565,0.45,44,150,0.293,210,415,0.506,0.488,194,256,0.758,47,249,296,75,29,9,61,69,746
2015,Elliot Williams\williel01,PG,26,MEM,5,0,45,2,10,0.2,1,4,0.25,1,6,0.167,0.25,3,4,0.75,1,3,4,4,0,0,1,2,8
2015,Lou Williams\willilo02,SG,29,LAL,67,35,1907,283,693,0.408,110,320,0.344,173,373,0.464,0.488,352,424,0.83,31,138,169,167,62,19,107,107,1028
2015,Marvin Williams\willima02,PF,29,CHO,81,81,2338,338,747,0.452,152,378,0.402,186,369,0.504,0.554,120,144,0.833,127,394,521,110,58,77,62,133,948
2015,Mo Williams\willima01,PG,33,CLE,41,14,748,132,302,0.437,36,102,0.353,96,200,0.48,0.497,38,42,0.905,6,66,72,98,14,5,57,60,338
2015,Justise Winslow\winslju01,SF,19,MIA,78,8,2232,195,462,0.422,32,116,0.276,163,346,0.471,0.457,80,117,0.684,81,322,403,117,68,26,95,184,502
2015,Jeff Withey\witheje01,C,25,UTA,51,10,658,87,162,0.537,0,2,0,87,160,0.544,0.537,43,59,0.729,56,117,173,20,21,53,28,75,217
2015,Christian Wood\woodch01,PF,20,PHI,17,0,145,22,53,0.415,4,11,0.364,18,42,0.429,0.453,13,21,0.619,13,25,38,3,5,7,2,11,61
2015,Metta World Peace\artesro01,SF,36,LAL,35,5,590,55,177,0.311,26,84,0.31,29,93,0.312,0.384,40,57,0.702,19,70,89,27,22,11,15,67,176
2015,Brandan Wright\wrighbr03,PF,28,MEM,12,2,212,35,52,0.673,0,0,,35,52,0.673,0.673,13,24,0.542,14,29,43,6,5,15,10,21,83
2015,Delon Wright\wrighde01,PG,23,TOR,27,1,229,36,80,0.45,5,13,0.385,31,67,0.463,0.481,26,35,0.743,8,29,37,31,8,3,16,7,103
2015,Tony Wroten\wroteto01,PG,22,PHI,8,3,144,22,65,0.338,3,17,0.176,19,48,0.396,0.362,20,37,0.541,2,19,21,20,3,0,29,11,67
2015,James Young\youngja01,SG,20,BOS,29,0,199,11,36,0.306,6,26,0.231,5,10,0.5,0.389,1,4,0.25,4,22,26,9,6,1,5,17,29
2015,Joe Young\youngjo01,PG,23,IND,41,0,384,62,169,0.367,10,46,0.217,52,123,0.423,0.396,20,25,0.8,6,44,50,65,15,0,33,30,154
2015,Nick Young\youngni01,SG,30,LAL,54,2,1033,126,372,0.339,77,237,0.325,49,135,0.363,0.442,63,76,0.829,14,83,97,34,23,7,30,50,392
2015,Thaddeus Young\youngth01,PF,27,BRK,73,73,2407,495,963,0.514,7,30,0.233,488,933,0.523,0.518,105,163,0.644,176,484,660,135,112,37,136,182,1102
2015,Cody Zeller\zelleco01,C,23,CHO,73,60,1774,231,437,0.529,1,10,0.1,230,427,0.539,0.53,175,232,0.754,138,317,455,71,57,63,68,204,638
2015,Tyler Zeller\zellety01,C,26,BOS,60,3,710,138,290,0.476,0,0,,138,290,0.476,0.476,88,108,0.815,62,116,178,29,10,22,46,97,364
